only	కేవలం సార్లు మాత్రమే
pm	రాత్రి గంటలు
record	రికార్డు
crore	కోట్ల నిధి
crores	కోట్లకు చేరింది
suggestion	ప్రతిపాదన
crore	కోట్లను రూ
respectively	లకు లభించనున్నది
crores	కోట్లు అందుకున్నాడు
crore	కోట్లు
crore	కోట్లు మూడో రోజు రూ
crores	కోట్ల
crore	కోట్లు ప్రాజెక్టుకు రూ
thousand	వేల
crores	కోట్లకు
crore	కోట్ల ఆదాయం వచ్చింది
crores	కోట్లు వెచ్చించింది
crore	కోట్లు
crore	కోట్లుగా నమోదు చేసింది
crores	కోట్లను స్వాధీనం చేసుకున్నారు
thousand	వేలు కదూ
million	లక్షలు వసూలు చేసింది
crores	కోట్లు సేకరించింది
crore	కోట్ల నికర లాభాన్ని నమోదు చేసింది
crores	కోట్లు
crores	కోట్లకు పైగా వసూళ్లు సాధించింది
lakh	కోట్లు
crores	కోట్లకు ప్రశంసించారు
crore	కోట్లు
crore	కోట్ల టర్నోవర్ నమోదు చేసింది
crores	కోట్ల ఆదాయం వస్తుంది
crore	కోట్లకు చేరాయి
crores	కోట్లు
crores	కోట్ల
crore	కోట్లు
crores	కోట్లను తాకింది
respectively	ఉన్నాయి
crores	కోట్ల
lakh	లక్షలకు పెరుగుతుంది
million	లక్షలు
school calendar	స్కూల్
others differ	దో తేడాగా ఉందని
facts	గుండెలు నిజాలు
new heights	న్యూ
crunch game	క్రాక్ గేమ్
hes both	ఆయన ఆ రెండూ
double century	డబుల్ సెంచరీ
online education	సమాజంలో ఆన్లైన్ విద్య
catch	పొందండి చిత్రాలు
and above	ఉంటుంది
camera	ఉత్తమ కెమెరా
yet again	మరోమారు
t return	తిరిగి
why so	అలా ఎందుకు అంటే
favourite movie	నాకు నచ్చిన సినిమా
dont	వద్దు
lake	చెరువు
onions chopped	ఉల్లిపాయలు చిన్న ముక్కలుగా
everyones problem	అందరి సమస్య
ambani house	ఇల్లు
in hyderabad	లోనే
common injuries	సాధారణ గాయాలు
recently rs	ఇటీవల తన అకౌంట్ నుంచి రూ
f rs	లైసెన్స్ లేకుండా డ్రైవింగ్ చేస్తే రూ
celebrity concern	సినీ ప్రముఖులు ఆందోళన
environmental disaster	పర్యావరణ సంక్షోభం
international	ఇంటర్నేషనల్
no disappointment	నిరాశ
or not	లేదా లేదు
crores respectively	కోట్లు
dont	మరీ వేడి చేయకండి
new	కొత్త
rs	జరిమానా వసూలు చేస్తారు
at rs	మరియు రూ
official statement	అధికారిక ప్రకటన
general	జనరల్
water	కొవ్వు
financially sound	ఆర్థిక పరంగా ఉంటుంది
language s	భాష
up	ఠక్కున
very good	బహు బాగుంది
exercise correctly	సరిగ్గా వ్యాయామం చేయటం
similarly rs	అదేవిధంగా రూ
s	ఎస్
rs lakh	లక్షల నగదు తీసుకుని వచ్చాడు
food	ఆహార
chaotic traffic	దూకుడు ట్రాఫిక్
is congress	కాంగ్రెస్
why cheat	ఎందుకు
budget allocations	బడ్జెట్ కేటాయింపు వివరాలు
i thought	మనసులో
big profits	భారీగా లాభం
traders comments	అభిప్రాయాలు
monthly fee	నెలవారీ బిల్లు
lakh crores	లక్షలు ఖర్చు చేశారు
your blood	మీ రక్తం
apple	ఆపిల్
ghee teaspoon	చెంచా
dont compete	పోటీ పడి
salary rs	వేతనం మొదటి ఏడాది శిక్షణ సమయంలో నెలకు రూ
children too	అలాగే సంతానం కూడా
people c	జనం
theyre growing	వాళ్లు
came along	తో వచ్చింది
alternative	ప్రత్యామ్నాయ వసతి
the bjp	బీజేపీ టీడీపీ
the marriage	పెళ్లికి వచ్చే
onions chopped	కొత్తిమీర సన్నగా తరిగి పెట్టుకోవాలి
rs crore	కోట్ల
women	మహిళలు
love signs	ప్రేమకు
everybody knows	అందరికీ సుపరిచితమే
holy picture	పవిత్ర చిత్రం
white bread	తెల్ల
youtube go	యూట్యూబ్ గో
looks scary	భయంకరంగా కనిపిస్తోంది
take	బ్యాక్ అప్ పొందండి
lakh crore	లక్షల కోట్లు
first ball	వికెట్
per bottle	ప్రతి లో
their names	వారి పేరు
crore more	కోట్ల కంటే ఎక్కువ లేదు
residential areas	నివాస ప్రాంతాల ప్రాంతం
again	మళ్లీ పెట్రో మోత
rs then	అప్పుడు నెలకు రూ
nothing wrong	ఏం
yes sir	సార్ సార్
basic recommended	ప్రాథమిక సిఫార్సు చేయబడింది
it tweeted	అంటూ ట్వీట్ చేశారు
why removed	ఎందుకు
chemical sciences	కెమికల్
god asked	అని
history repeats	రిపీట్
sweeping allegations	ఆరోపణలు
you promise	మీరు వాగ్దానం
other	మరికొన్ని ఆవిష్కరణలు
hair colour	జుట్టు రంగు
method	కుదింపు పద్ధతి
rs crore	కోట్లు తేలింది
increasing cases	కేసులు పెరగడానికి
even rs	రూ
per cent	శాతం
it	దాని ఆధారంగా
modi along	దీదీ
iphone c	ఐఫోన్ కెమెరాలు
numbers	సెల్ ఫోన్ నంబర్లు
car reviews	వాహనం యొక్క సమీక్షలు
special night	ప్రత్యేకమైన రాత్రి
loan recovery	రుణ పునర్నిర్మాణం
hollywood	హాలీవుడ్ లీక్
lakh crores	లక్షల కోట్లకు చేరింది
pacific ocean	పసిఫిక్
disease	వ్యాధి భారం
each district	్రతి జిల్లాలో
regular	రెగ్యులర్
moreover rs	అంతేకాదు కోసం పథకం ద్వారా నెలకు రూ
good actress	మంచి నటుడు
hes	అతను ఉంది
us travel	అమెరికాలో
command positions	స్థానం ఆదేశాలు
ask me	కూడాను
womens rights	ది ఆఫ్ రైట్స్
onion g	గ్రాముల
controversial church	ఘర్షణ చర్చి
world	బ్రిటన్ నుంచి ప్రపంచానికి
new regulations	నూతన పరిచయం
read here	ఇక్కడ చదవండి
thats questionable	అన్నది ఏదేమైనా
approve	ను
series leaders	సిరీస్ నాయకులు
research	రీసెర్చ్
he turns	ఏళ్లు వచ్చినా
payment plans	ఆఫ్
and hello	మరి ఏ హై
key events	ముఖ్య
step three	మూడు
no	బాధ ఉండదు
daily reports	రోజూ నివేదిక
presently rs	ప్రస్తుతం రూ
world cup	అందించారు
crore revenue	కోట్లకు
never ever	ఎప్పుడూ చేయకపోతే
basic rules	ప్రాథమిక నియమాలు జాబితా
attractive salary	వేతనాలు
market	మార్కెట్
sugar tablespoons	టేబుల్ స్పూన్లు
organisations schools	పాఠశాలలు సంస్థలు
china unit	చైనా
the staff	సిబ్బంది అందిస్తున్న
making change	మార్పు చేస్తున్నాం
fabulous music	అద్భుతమైన సంగీతం
control	బడ్జెట్ నియంత్రణ
and really	మరి నిజంగా
crores each	కోట్లు ఇవ్వాలి
home grown	ఇంట్లోనే
popular destinations	ప్రసిద్ధ
engineering construction	ఇంజనీరింగ్ మరియు నిర్మాణం
bjps loss	బీజేపీ ఘోర పరాజయం
additional services	అదనపు రుసుము
more education	మరింత విద్య
not pooja	కాదు
actually impossible	అసలు కుదరదు
window	కొత్త విండో
already rs	ఇప్పటికే మూడు రూ
review	రివ్యూ అండ్ రేటింగ్
rs crores	కోట్ల రూపాయలను అందజేశారు
them	బోల్తా
command directive	కమాండ్ ఆదేశం
greater good	మహా మేలు
people killed	మంది మృతి
debate	సాహిత్యం చర్చ
k	కె
thereby he	దీంతో అతని
again why	మరెందుకు
is free	ఉంటుంది
then t	అప్పుడు
no review	సమీక్ష లేకుండా
it	ఐటి సోదాలు
field	ఫీల్డ్
common symptoms	వ్యాధి మహత్తర లక్షణాలు
electric plane	ఎలక్ట్రిక్ విమానాలు
cultural	సాంస్కృతిక సంబంధాలు
still	ఇప్పటికీ పరిష్కారం కాలేదు
photos layout	నమూనా
its clear	అంటూ స్పష్టం చేశారు
all quiet	అంతా
judgement reserved	తీర్పు రిజర్వ్ చేసింది
arts	ఆర్ట్
superb movie	సినిమా
extreme sports	క్రీడలు
decreased productivity	తగ్గిన
asked	అని
debt	ఇక రుణం
memory games	ఆటలు
to rs	తగ్గి రూ
lakh rs	లక్షలు అంటే నెలకు రూ
indian batsman	భారత బ్యాట్స్మన్
discipline must	క్రమశిక్షణ
use technology	టెక్నాలజీని
promotes immunity	రోగనిరోధక
to rs	నుండి రూ
big	గొప్ప బ్రేక్
godavari river	చుట్టూ గోదావరి నది
of nominations	వేస్తూ
im leaving	వదిలిపెట్టి
rs crore	కోట్ల బడ్జెట్తో నిర్మించింది
itchy eyes	కళ్ళు చప్పుడు
hyderabad	హైదరాబాద్
asks	అడిగాడు
social	సామాజిక
covid	కోవిడ్
rs	రూ రూ
i asked	అని అడిగాను
no hunger	ఆకలి ఉండదు
causes	ఊపిరితిత్తుల సంబంధిత కారణాలు
miss why	భార్య ఎందుకు
whos	హర్షం వ్యక్తం చేస్తున్నారు
everyones happy	అందరూ సంతోషంగా
added pressure	ఒత్తిడి పెంచారు
private work	ఉద్యోగం చేస్తున్నాడు
love birds	ప్రేమ పక్షులు
career comeback	వృత్తి
lakh crore	లక్ష కోట్లు
great success	అద్భుత విజయం
no matter	లేదు
indian history	ఇండియన్
lakh loss	లక్షల నష్టం
barack obama	ఒబామా
father retired	నాన్నగారు
executive director	డైరెక్టర్
however rs	అయితే కలిపి రూ
death	మరణం
game time	గేమ్ సమయంలో
it costs	దీంతో ఖర్చు
cyber	సైబర్ ఆయుధం
bollywood career	బాలీవుడ్ కెరీర్
hair	జుట్టు
first month	మొదటి నెల రూ
camera features	కెమెరా ఫీచర్
priced at	కే ఆఫర్ చేస్తోంది
dark games	ఆటలు
is rs	సంవత్సరానికి తనకు రూ
bjp government	ఇక నేతృత్వంలోని ప్రభుత్వ
becoming an actress	నటి
density of materials	మెటీరియల్ మందం
mr siva counsel	మిస్టర్ శివ
it me	అని నన్ను
whats the story	కథ
low on funds	నిధులు తక్కువగా
everything has happened	అన్నీ చకచకా జరిగిపోయాయి
lucky colour	లక్కీ కలర్ గోధుమ రంగు
is it really	ఇది నిజంగా ఈజ్
in hyderabad	హైదరాబాద్లో
effect on loans	వీటి ఎఫెక్ట్
because its	ఎందుకంటే అది బందీ
price at rs	ధర రూ
design and engineering	ఇన్ఫ్రాస్ట్రక్చర్ అండ్ డిజైన్
thats the movie	అదీ సినిమా
and sexy	సెక్సీ మరియు
parents foul	గుండెలు తల్లిదండ్రులు
issued an apology	క్షమాపణలు చెప్పాడు
enhances communication skills	కమ్యూనికేషన్ నైపుణ్యాలు అభివృద్ధి
five thousand crore	ఐదువేల కోట్లు
sbi life buy	ఎస్బీఐ లైఫ్ ఇన్సూరెన్స్ టార్గెట్ రూ
district	జిల్లా
day special	డే స్పెషల్
bring tea immediately	టీ వెంటనే
workers to protest	కార్మికులు
whos in it	అందులో ఉన్నది ఎవరు
its another step	ఇదొక మరో కొత్త అడుగు
can you win	మళ్లీ
you are leaving	మరి
a challenging city	సవాలుగా ఉన్న నగరం
where to start	ఎక్కడి నుంచి
well almost anything	అవును దాదాపు ఏదైనా
for farmers rs	రైతుకు పంట ఎకరానికి రూ
pick a name	క్రొత్త పేరుని ఎంచుకోండి
places names	వీటిని ఫండ్స్ అంటారు
about the protest	గురించి
high road	రోడ్డు ఎక్కువ మరణాలు
buy	ప్రస్తుత ధర రూ
its not wrong	తప్పు కాదు
hes not fat	అతను భారీ కాదు
about children participated	మంది పిల్లలకు భోజనం
yes it did	అవును
registration is free	మరియు నమోదు ఉచిత ఉంది
save and quit	మరియు
cup paste	కప్పు తురిమిన చీజ్
men not allowed	ప్రవేశం లేదు
shares and securities	షేర్లు
becoming less active	తక్కువ చురుకుగా ఉండటం
and braking	అండ్ బ్రేకింగ్
types of	రకాలు
low theme	తక్కువ
i am surprised	నేను
dont go away	అని చెప్పింది
inflation expectations	అంచనాలను
seeing it all	ఇవన్నీ
featured complete	విశేష పూర్తి
the three are	వారు ఉన్నారు
list of actions	చర్యలు జాబితా
mr rao	శ్రీ రావు
polavaram project works	పాలమూరు
take immediate action	వెంటనే చర్యలకు
the material includes	పదార్థం క్రింది పదార్థాల నుంచి తయారు చేస్తారు
bring it home	స్వదేశానికి
follow traffic rules	ట్రాఫిక్ రూల్స్
new rs	చెన్నై వెబ్సైట్ ప్రకారం కొత్త రూ
im in heaven	నేను
its very beautiful	ఇది చాలా అందంగా ఉంది
the judges asked	అని ప్రశ్నించారు
crores and rs	కోట్లు అల్లుడు రూ
i cant do	నేను
dont go back	తిరిగి
families in	చీకటి కుటుంబాల్లో
of the rs	వారి వద్ద నుంచి రూ
so far rs	ఇప్పటివరకు భారతదేశ చరిత్రలో రూ
three thieves held	ముగ్గురు దొంగలు
lakh at least	లక్షల వరకు చెల్లించాల్సి ఉంది
so say it	కనుక చెప్పి
mind is	వక్రించింది
people in the	ప్రజలు
yes say researchers	అంటే అవుననే విశ్లేషకులు చెబుతున్నారు
its totally	పూర్తిగా వుంది
rule of law	చట్టబద్ధమైన పాలన
whats the story	ఏమిటా కథ
kl rahul out	ఓపెనర్ కేఎల్ రాహుల్ అవుట్
keep it fun	ఉండండి
how to do	ఎలా చేయాలి
courtesy the hindu	హిందూ
no required	ఇందుకు ఎలాంటి అవసరం లేదు
k chandrasekhara rao	కె
available remote addons	రిమోట్
the right hand	కుడి
none of english	ఇంగ్లిషు లేదు
something was	ఏదో ఉండేవారు
notices to	నోటీసులు
the materials include	దీని
one such video	ఇలాంటి ఒకటి
course fee rs	కోర్సు రుసుము రూ
no reasons given	ఎలాంటి కారణాలు చెప్పలేదు
join the debate	చర్చలో
by the sea	సముద్రం ద్వారా
the complete picture	ది కంప్లీట్
the village story	కథ
key benefits include	యొక్క ప్రధాన ప్రయోజనాలు ఉన్నాయి
youre a boy	నువ్వా
lakh delhi	లక్షలు గా ఉండవచ్చు
pakistan is	నిప్పులు
crore and above	కోట్లను వెల్లడించింది
and his	తన
not the both	అంతే కాదు ఇద్దరికీ కూడా
listen to music	సంగీతం
kerala bars	కేరళలో
money is spent	డబ్బు వృథా అవుతుంది
restoration of	హోదా పునరుద్ధరణ
keeps cancer away	క్యాన్సర్ రాకుండా నివారిస్తాయి
time and	సమయం మరియు
you are alone	నువ్వే మరి
colours and	మరియు రంగుల
other medical conditions	ఇతర ఆరోగ్య పరిస్థితులు
its not	అది భయం కాదు
director srinivas raju	దర్శకుడు శ్రీనివాస్ రావు
aamir khan brother	కరణ్ ఆమిర్ ఖాన్ సోదరుడు
the examination committee	పరీక్షా కమిటీ
types of loans	రకాల
i am safe	నాకు భద్రత
a new museum	ఓ కొత్త మ్యూజియం
photo credit	ఫోటో క్రెడిట్
implementation is key	అమలు కీలకం
picture on page	వ పేజీలోని చిత్రం
europe and asia	టు యూరోప్ అండ్
important documents seized	పలు కీలక స్వాధీనం
best indian batsman	టీం ఇండియా బెస్ట్
few it	కొద్దిమంది
or	లేదా
why building	ఎందుకు భవనం నిర్మాణ కల
whats the	ఏమిటి
use light colours	ఉపయోగించండి
not to miss	కోల్పోవడం లేదు
he was surprised	అని
so keep smiling	ఐతే అలా
the man	మనిషి
the other mp	మరో ఎంపీ కూడా
so is china	అలాగే చైనా కూడా
thank u everyone	అందరికి ధన్యవాదాలు
and care	సాగు మరియు హార్వెస్టింగ్
two years previously	రెండు సంవత్సరాల క్రితం
apple iphone s	యాపిల్ ఐఫోన్ ఎస్
cost of tickets	టిక్కెట్ ధర
focus on achievement	విజయంపై దృష్టి
style and technique	మరియు టెక్నాలజీ
history culture beauty	సంస్కృతి మతం చరిత్ర
its pure fun	ఈ ఒక స్వచ్ఛమైన సరదాగా ఉంటుంది
the plans include	ప్రణాళిక క్రింది అంశాలను కలిగి
some like it	అందులో కొన్ని
statistics speak	గణాంకాలు ఉంటాయి
security is lax	భద్రతా
times	టైమ్స్
im very happy	నాకు చాలా ఆనందంగా ఉంది అని వ్యాఖ్యానించింది
sounds like fun	అనిపిస్తుంది
ward no	నెం
lets see how	ఎలా చేయాలో మరి
impact on markets	ఎఫెక్ట్
alcohol is	మద్యం జరిగింది
why just politicians	రాజకీయ దాకా ఎందుకు
rs lakh seized	లక్షలు స్వాధీనం చేసుకున్నారు
how to treat	ఎలా వ్యాధి చికిత్స
power supply	విద్యుత్ సరఫరా
has anyone responded	ఎవరైనా చేశారా
educational qualification	అర్హత ఉత్తీర్ణత
the movie delivers	సినిమా
a strategy	నిర్ణయం
i found it	ఇది నేను
producer dil raju	నిర్మాతలు దిల్ రాజు
for	దరఖాస్తు
who launched it	ఎవరు
can be used	ను
hes the one	అతను అతనే
arent women	మహిళలు లేరా
the state health	రాష్ట్ర వైద్య ఆరోగ్య శాఖ
file photo	ఫోటో
mustard half teaspoon	పంచదార టీస్పూన్
i love france	కానీ ఫ్రాన్స్ అంటే
lakhs in cash	లక్షల క్యాష్
many are dying	ఎంతో మంది
additional taxes apply	దీనిని అదనపు చార్జీలు వర్తిస్తాయి
being searched	శోధన
songs are sung	పాటలు
committee recommendations	కమిటీ
suitable for everyone	అందరికీ
whats the benefit	ఏం లాభం జరుగుతుంది
congress bjp marches	కదలని కాంగ్రెస్ బీజేపీ
trade and investment	పెట్టుబడి మరియు వ్యాపార
heaven or	లేదా
if all goes	అన్ని సక్రమంగా ఉన్నా
thats the hope	ఇది ఆశలు
problem solved right	కదా
doctors are shocked	దీంతో సదరు వైద్యులు షాక్ అయ్యారు
the king	రాజు వేశాడు
rs to rs	కోట్ల నుంచి రూ కోట్లు రూ
however at rs	అయితే దీన్ని రూ
meters of land	భూమి యొక్క మీటర్లు
the first rs	నిలిచిన మొదటి రూ
and love	లవ్ మరియు నిరాశ
repeat if necessary	అవసరమైతే
amaravati farmers protest	అమరావతి రైతుల దీక్షలు
it was crore	కోట్ల భారం అన్నారు
end of over	తో
thanks once again	ధన్యవాదములు
tarnished golden dreams	ప్రాణాలు తీసిన బంగారు కలలు
experience matters too	అనుభవం కూడా పరిగణనలోకి తీసుకుంటారు
politics has changed	రాజకీయాలు మారుతున్నాయి
but in politics	కానీ కానీ రాజకీయాల్లో కానీ
whats the use	ఉపయోగం ఏమిటీ
launched farmers movement	వ్యవసాయ కూలీల ఉద్యమం నిర్మించాడు
and who wins	మరి విజయం ఎవరిని వరిస్తుందో
director surender reddy	సురేందర్ రెడ్డి
buildings and	భవనాలు మరియు
driving the car	కారు చేయటం
people make mistakes	ప్రజలు తప్పులు చేస్తారు
culture and arts	సంస్కృతి
cow seed rs	రూ
investment and loans	పెట్టుబడులు రుణాలు తీసుకోవడం
exercise and activity	వ్యాయామాలు మరియు అంశాలు
he was detained	ఆయన్ని చుట్టుముట్టి
he immediately	తక్షణం క్షమాపణ చెప్పాలని ఆదేశించింది
he replied likewise	వాడు కూడా చేసాడు
he has rs	ఆయన సినిమాకు రూ
high success rate	అధిక విజయం రేటు
nobody knows them	ఎవరూ తమకు
she was	ఆమె మనసు
we are sportsmen	మేము
whats doing well	ఏం బాగా
s it true	నిజమే కదా
peace and	శాంతి మరియు
crore indian rupees	కోట్ల రూపాయలకు కైవసం చేసుకుంది
assets worth rs	ఆస్తులు రూ
why so	అంత
jobs and wages	జీతం మరియు వేతనాలు
lakh and rs	వేలు రూ
wouldnt you know	కాదని తెలిస్తే
where was it	ఎక్కడ ఉండేది
he loves	అతనికి చాలా ఇష్టం
ideas are shaped	ఆలోచనలకు రూపకల్పన జరుగుతుంది
easy and	మరియు తేలిక
we went ahead	న
national construction company	నేషనల్ కన్స్ట్రక్షన్ కంపెనీ
the list is	ఆ
we are fighting	మేమిద్దరం
light and dark	మరియు కాంతి
state govt employees	ప్రభుత్వ ఉద్యోగులను
if it snaps	అది
vehicles being checked	వాహనాలను తనిఖీ చేస్తున్నారు
mode of operation	ఆపరేషన్ మోడ్
honor her wishes	తన
i did films	నేనే సినిమాటోగ్రఫీ చేశాను
do not vote	ఓట్లు
you ask them	అని వారిని అంటూ వ్యక్తం చేసింది
the rate rs	ల రేటు చొప్పున రూ
he got married	చేసుకున్నాడు
water is essential	నీరు
path to	మార్గం
not so anymore	ఇక అలా కాదు
it was delayed	అది వాయిదా
crore was allocated	కోట్లు కేటాయించింది
at every turn	ప్రతి
we had doubts	దీంతో మాకు అనుమానం వచ్చింది
modi in america	అమెరికాలో మోడీకి
do you drink	తాగావా
and road	అండ్ రోడ్
just one million	కేవలం లక్షన్నర
how can apply	ఎలా
the panel includes	మడత పట్టిక క్రింది లక్షణాలను కలిగి ఉంటుంది
congress leaders	కాంగ్రెస్ లీడర్స్
free eye operations	ఆపరేషన్స్
the district magistrate	జిల్లా సమాధానం
srinagar district rs	పరిధిలో రూ
the asked	అడిగాడు
the rent court	కోర్టు
whats to celebrate	ఏమి
top button d	పైన బటన్
but not everyone	అయితే అందరికీ మాత్రం కాదు
at the moment	అని తెలిపారు
be here	అతను ఇక్కడే
labour laws	కార్మిక సవరణ
to health	ఆరోగ్యం
and peace	మరియు శాంతి
everyone lives for himself	అందరిలానే
axis bank shares rise	శాతం యాక్సిస్ బ్యాంక్ షేరు
why did he	తను
allow us to explain	మాకు వివరించేందుకు లెట్
the question for rs	అంటూ రు
such opportunities are rare	ఇలాంటి అవకాశాలు అరుదుగా వస్తాయి
too are changing	విధానం కూడా మారుతుంది
crore for the programme	వేల కోట్లు కేటాయించింది
lakhs by mumbai indians	లక్షలు లకు ముంబై దక్కించుకుంది
each individual is different	ఒక్కొక్కరి ఒక్కోలా ఉంటుంది
writer poet	కవి రచయిత మరియు
wishes to everyone	ప్రతి ఒక్కరికీ
it is very	చాలా ఇబ్బందిగా ఉంది అని రష్మిక తెలిపింది
hes played cricket	ఫస్ట్ క్లాస్ క్రికెట్లో
the skin becomes smooth	చర్మం
tennis	టెన్నిస్ కు దూరం కానున్న
a lot of it	పుష్కలంగా
but thats not it	కానీ అది కాదా
check out all details	అన్ని వివరాలు
thank you ravi	థ్యాంక్స్
has it ever happened	ఇది ఎప్పుడూ
the group the	వేదికపై జరిగిన ఆసియా గ్రూప్
crore and rs	కోట్లు రాజీవ్ కింద రూ
he had lost election	గత ఎన్నికల్లో ఆమె రెండోస్థానంలో నిలిచారు
post name assistant engineer	పోస్టు పేరు జూనియర్ ఆఫీసర్ అసిస్టెంట్
healthy skin and hair	చర్మం జుట్టు ఉంటాయి
i met him frequently	నను తరచుగా
nobody to anybody	ఎవరూ ఎవరి మాటా పరిస్థితి లేదు
why would i lie	ఎందుకు మోసం చేస్తున్నారు
kcr is the cm	అని సీఎం కేసీఆర్ చెప్పారు
ways to reduce stress	ఒత్తిడి తగ్గింపు పద్ధతులు
follow the doctors advice	డాక్టర్ల సూచనలు పాటించండి
state government	ప్రభుత్వం
its several times higher	ఇది ఎన్నో రెట్లు పెరిగింది
who is my mother	తల్లి ఎవరు
he must think quickly	మీరు త్వరగా
the bjp responded	దీనిపై బీజేపీ తీవ్రంగా స్పందించింది
improve focus and	దృష్టి చేస్తుంది
nobel prize in science	నోబెల్ బహుమతి
how big is it	ఎంత పెద్దగా ఉన్నాయి
but it looks like	కానీ
green chilli finely chopped	పచ్చిమిర్చి సన్నగా
it isnt so easy	అంత
and others participated	నాయక్ తదితరులు ఈ కార్యక్రమంలో పాల్గొన్నారు
no discussions at present	చర్చలు లేవు
star wars and peace	యుద్ధాలు మరియు శాంతి
the tdp has quit	టీడీపీని
are you for real	ఇది
the are strong	గట్టిగా ఉన్నాయి
so far its good	ఇంతవరకూ బాగానే వుంది
bangalore university	యూనివర్సిటీ బెంగళూరు
kids got it	కిడ్ అది
its not a positive	ఇది సానుకూల పాత్ర లేదు
get the new	కొత్త పొందండి
how are judges chosen	ఎంపిక ఎలా జరుగుతుంది
its a great experience	ఇదొక చక్కని అనుభవం
tdp chief chandrababu naidu	అని తెదేపా అధినేత చంద్రబాబునాయుడు మండిపడ్డారు
qualification	అర్హత సంబంధిత విభాగంలో ఎండీ ఉత్తీర్ణత అనుభవం
shetty cant contest elections	ఎన్నికలలో పోటీ చేయడానికి వీల్లేదు
documents to avail loan	రుణం కోసం అవసరమైన పత్రాలు
is it a risk	ప్రమాదం కదా అంటే చిన్నప్పట్నుంచీ ఉన్నాం
even hindus eat	హిందువులు కూడా తింటారు
labour and authority	అండ్ అథారిటీ
why do you think	ఎందుకు కానీ
suicides by farmers continue	రైతుల కొనసాగుతోంది
want to increase height	మీరు ఎత్తు
houses are up	ఇండ్లు
how did he die	అతడికి ఎలా
two killed in shootout	ఘటనా ఇద్దరి మృతి
i can make suggestions	సలహాలు
please please come quick	నన్ను త్వరగా అక్కడకు అన్నాడు
bjp leaders are lying	బిజెపి నాయకులు చేస్తున్నారని అన్నారు
but i dont worry	కానీ నేను
god results are	చెప్పిన విషయాలు
no need to be	అవసరం లేదు కూడా
some things havent changed	కొన్ని మారలేదు
but he wasnt scared	అయినా తాను అన్నారు
a mother and child	పిల్లలు కూడా
it received tremendous response	దానికి అద్భుతమైన స్పందన వచ్చింది
rates are high	మృతుల రేటు ఇక్కడ ఎక్కువే
but thats really it	కానీ ఇది నిజమైన విషయం
he denied the reports	ఈ తెలిపారు
we already made plans	అప్పుడే ప్రణాళికలు సిద్ధం
let us it	దాన్ని మనం అని
do not anything	ఏమాత్రం నిర్లక్ష్యం చేయకూడదు
we can only	మేం కేవలం సాయం చేసి
in the past rs	గతంలో ఇల్లు కోసం రూ
black and gold	బ్లాక్ అండ్ గోల్డ్
mix the dry ingredients	పొడి మిశ్రమం కలపాలి
go back to sleep	ఇటు తిరిగి
another blow for tdp	ఏపీలో టీడీపీకి మరో షాక్ తగిలింది
please select an option	ఒక ఎంపికను ఎంచుకోండి
are as follows	రెసిపీ ఈ క్రింది విధంగా ఉంటుంది
their objective is different	వీరి ప్రవృత్తి మాత్రం దానికి
choose start menu folder	స్టార్ట్ మెనూ ఎంచుకోండి
then we do it	ఆ తర్వాత మేమే
corridor speed	వేగం రవాణా
and are working	మరియు వారు పని చేస్తుంది
he is very good	ఆయన చాలా ఎవరికి కష్టం వచ్చినా
we too should change	మనమే ఇంకా వుంది
is the ice melting	మంచు
pawan kalyan file photo	పవన్ కళ్యాణ్ ఫైల్ ఫొటో
change your email	మీ
loans to rs	ఇచ్చిన రుణాలు రూ
only some came back	కొందరు మాత్రమే ముందుకు వచ్చారు
cost price on request	బేస్ ధర
the car door opened	అంటూ కారు
the same was done	దే చేసింది
but she denies it	కానీ ఆమె ఓ
it can be anyone	అది ఎవరికైనా రావొచ్చు
it is totally false	ఇది పూర్తిగా అబద్ధం
virat eyes another record	విరాట్ మరో రికార్డ్
workers salary enhancement	పెంపు
nobody can avoid it	ఎవరూ
the number is rising	కౌంట్ పెరుగుతోంది
but the information	అయితే సమాచారం అయింది
green chilli finely chopped	గ్రీన్ క్యాప్సికమ్ సన్నగా కట్ చేసుకోవాలి
its no laughing matter	ఏం ప్రమాదం లేదు
in the past decade	గత
health insurance policy	ఆరోగ్య బీమా పాలసీ కదా
where is happiness located	మీకు ఆనందం ఎక్కడ దొరుకుతుంది
i like his acting	అయన నటన అంటే నాకు ఇష్టం
history to on	చరిత్ర ఆర్
digvijay singh file photo	దిగ్విజయ్ సింగ్ ఫైల్ ఫొటో
petrol prices in rs	పెట్రోల్ ధరలు చిత్రం
he has married twice	ఆమె రెండుసార్లు వివాహం చేసుకుంది
why i do it	నిజానికి ఎందుకు చేస్తాను
how is treated	చికిత్స ఎలా
the same happened here	సరిగ్గా ఇక్కడ కూడా అదే జరిగింది
such things keep happening	ఇలాంటి సంఘటనలు జరుగుతూనే ఉన్నాయి
theres no such thing	అలాంటిదేమీ
why is it popular	ఎందుకు సరిగ్గా ఇది ప్రజాదరణ ఉంది
such a fun movie	అంత సినిమా
women are not safe	రక్షణ లేకుండా
the railways get rs	ఏటా రూ
most important of all	అతి ముఖ్యమైన విషయం
crore to the state	కోట్లు ప్రభుత్వ పడ్డాయి
he asked his son	నేరుగా కొడుకును అడిగింది
each has symptoms	ప్రతి వ్యాధి లక్షణాలు
but she isnt	కానీ ఆమె పని లేదు
how it exactly works	ఇది ఎలా సరిగ్గా పనిచేస్తుంది
he is doing nothing	ఏ ఉంటాడు
the house burns down	ఇల్లు
are values being	విలువలు
where are the kids	ఎక్కడి చిన్నారులు
the pension of rs	పింఛను మొత్తాన్ని రూ
cant you see anything	ఏదీ
soon another crisis	తాజాగా మరో భయంకరమైన సంక్షోభం కూడా ముందుకు వచ్చింది
recently updated complete	ఇటీవల పూర్తి
nobody is our enemy	మాకు లేని ప్రతి ఒక్కరూ
you can go later	తర్వాత
the working of the	పని
such is our life	మన రోజులు
congress supports bharat bandh	భారత్ కాంగ్రెస్ మద్దతు
it is exalted indeed	ఇది నిజమైన ఉన్నత ఉంది
who owns the car	కారులో ఉన్న వ్యక్తి ఎవరు
another player gets injured	మరో క్రికెటర్
cant i be okay	నేను బాగా
great man he is	గొప్ప మనిషి ఆయన
i want a job	నాకు జాబ్ వుంది
his fit is great	ఆమె
he works very hard	తను బాగా
just for the name	కేవలం పేరు
the movie cost rs	ఆ సినిమాకు రూ
but doesnt agree	కాని
but its so wrong	అయితే ఆలా చేయటం చాలా తప్పు
violence never long	ఎక్కువ కాలం
not in my mind	మనసులో అనుకోలేదు
click for more details	పూర్తి కోసం క్లిక్ చేయండి
how the case started	కథ ఎలా
it violates the law	అది చట్టాన్ని అవుతుంది
she is a heroine	అంటోంది ఈ హీరోయిన్
she did not agree	ఆమె ఒప్పుకోలేదు
drug abuse in bollywood	బాలీవుడ్లో డ్రగ్స్
pick the right one	సరిగ్గా ఎంచుకోండి
bjps in karnataka	కర్నాటకలో బీజేపీకి
here it is happening	ఇదిగో ఇలా
symptoms of the virus	వైరస్ లక్షణాలు ఇవే
he was very simple	అతను చాలా ఉన్నాడు
are you a child	కొడుకు కదా
dollar notes file photo	ఫైల్ ఫొటో
doesnt seem like it	ది నచ్చడం ఉంది
girl student commits suicide	విద్యార్థిని ఆత్మహత్య
the many viruses	ఎన్నో
when was it registered	రిజిస్టర్ అయ్యారు
the distance is km	కిలో మీటర్ల దూరంలో
another amount of rs	ఇతర రూపంలో మరో రూ
we welcome the decision	ఈ నిర్ణయాన్ని
based on real events	వాస్తవ ఆధారంగా
the company has recently	తాజాగా ఈ సంస్థ
did he feel	అతను
types of heart disease	వాపు రకాలు
he screamed for help	దీంతో సహాయం కోసం గట్టిగా
the design is fantastic	దీని ఒక అద్భుతం
dark on skin	మచ్చలు
he didnt mind though	అయినా అతడు పెద్దగా పట్టించుకోలేదు
how do fly	ఎలా
manu bhaker wins gold	పథకం మను భాకర్
if not act fast	చేయకపోతే
lakh delhi	లక్షలు ఎక్స్ షోరూమ్ ఉన్నాయి
always follow manufacturers instructions	మీరు ఎల్లప్పుడూ ఉపయోగం కోసం సిఫార్సు సూచనలను
unveils radio	రెండు విడుదల చేసిన
however no one	అయినా ఎవరూ
thats one lucky baby	ఇది కేవలం మంచి సంతానం
was the data	మీరు ఇచ్చిన సమాచారం
it should be encouraged	దీనిని
issue of workers	వలస కూలీల ఆందోళన
benefits of fasting	దీక్ష వలన కలిగే ప్రయోజనాలు
it comprises three members	ఇది మూడు కూడి ఉండాలి
certainly anything is possible	వాస్తవానికి ఏదైనా సాధ్యమే
not just weight loss	కేవలం బరువు కాదు
crore to sell it	లక్షలకు విక్రయిస్తోంది
dr arjun sharma son	డాక్టర్ అర్జున్ శర్మ కుమారుడు
the results are good	అనుకూలమైన
violence isnt the solution	హింస పరిష్కారం
gold and silver prices	స్థిరంగా బంగారు వెండి ధరలు
one can doubt it	అన్న సందేహం
how to	ఏం పుట్టగొడుగులను ఉడికించాలి ఎలా
she had four children	ఆమె నాలుగు పిల్లలు జాగ్రత్త తీసుకున్నారు
all are playing well	అందరూ బాగా నటిస్తారు
doctors are not gods	డాక్టర్లు జంతువులు కాదు
security deposit of rs	సెక్యూరిటీ డిపాజిట్ ఉంటుంది
dont worry about him	అతని గురించి
the war is ended	యుద్ధము ముగుస్తుంది
dont forget to smile	చేసినా మాత్రం మర్చిపోవద్దు
the bjp won seats	స్థానాల్లో బీజేపీ
delhi assembly elections aap	ఢిల్లీ అసెంబ్లీ ఎన్నికల్లో ఆప్
she is gorgeous	తను చాలా అందంగా ఉంది
am i a terrorist	అయినా నేను
allahabad high court verdict	అలహాబాద్ హైకోర్టు సంచలన తీర్పు
im truly in shock	సలు షాక్ నేను
inch full hd display	ఫుల్ హెచ్డీ డిస్ప్లే
doctors finally him	ఎట్టకేలకు వైద్యులు ఆమెను చేశారు
happy for the family	ఆనందం
how would it decide	ఆ నిర్ణయం ఎలా ఉండొచ్చు
who won who lost	ఎవరు ఎవరు
he looks it too	ఆయన కూడా చూడండి అన్నారు
then add the carrots	అప్పుడు జోడించండి
government has committed rs	ద్వారా ప్రభుత్వం రూ
but these werent implemented	కాని ఇవేవీ అమలుకు నోచుకోలేదు
happy republic day wishes	గణతంత్ర దినోత్సవ శుభాకాంక్షలు తెలిపిన
buying a new phone	కొత్త ఫోన్
his leg was broken	దాని కాలికి దెబ్బ తగిలింది
control blood cholesterol level	కొలెస్ట్రాల్ ను కంట్రోల్ చేస్తుంది
is it a marriage	పెళ్లి అయితే
its just a language	ఇది ఒక భాష ఒంటరిగా ఉంది
come and sit down	లోపలికి రా అని సీట్
always speak the truth	ఎల్లప్పుడూ నిజం చెప్పండి
their wont go waste	వారి వృథా
his father was a businessman	అతని తండ్రి ఆర్థికంగా పనిచేశారు
but hes a good writer	కానీ ఆయన గొప్ప రచయిత
he was not in attendance	హాజరుకాలేదు
then everyone would be happy	అప్పుడు అందరూ ఆనందంగా ఉండవచ్చు
but it yielded no result	కానీ అది ఏ మాత్రం ఫలితం ఇవ్వలేదు
recently the centre allotted rs	ఇటీవలే కేంద్రం రూ
id never met him before	నేను ముందు అతనిని ఎప్పుడూ
rs crore is not peanuts	కోట్లు కాదని అది రూ
why not on political	రాజకీయ ప్రాధాన్యత లేకుండా
im deeply grateful to them	వారికి కృతజ్ఞతలు
the poor are becoming	మరింత
is chandrababu scared of bjp	బీజేపీకి చేస్తున్న చంద్రబాబు
rishabh pant plays a shot	వికెట్ కీపర్గా రిషబ్ పంత్
bills to around rs	బిల్లు దాదాపు రూ
nobody has touched it yet	ఇప్పటివరకూ ఈ ఎవరూ చేయలేదు
how much do you need	నీకు కావాలి
theres a number of ways	అనేక మార్గాలు ఉన్నాయి
prices rise as a result	దీనివల్ల వస్తున్నాయి
yahweh spoke to saying	అప్పుడు యెహోవా ఇశ్రాయేలీయుల
so do not push them	కనుక వాటిని తీసుకోకూడదు
most farmers are in	అధిక భాగం
it is still in service	ఇంకా ఉంది
and a fight it was	మరియు ఒక గొప్ప యుద్ధం ఉంది
huge traffic jam in hyderabad	హైదరాబాద్ మహా నగరంలో భారీగా నిలిచిన ట్రాఫిక్
still i enjoyed many blessings	అయినా నేను ఎన్నో
tdp activist hacked to death	టీడీపీ ఆత్మహత్య
because we dont need it	ఎందుకంటే దాంతో మనకు అవసరం లేదు కనుక
its no different in bollywood	బాలీవుడ్లో లేదు
most of them are muslims	వారిలో ఎక్కువగానే ఉన్నారు
however he did not	అయినా తను
congress slams the bjp government	కాంగ్రెస్ ప్రభుత్వంపై భాజపా దిగింది
cm kcr in tough spot	సీఎం కేసీఆర్ దిగ్బ్రాంతి
another chance to get registered	మరో ఛాన్స్
but no one is dying	కానీ ఈ అని కాదు
the bjp is strong here	ఇక్కడ వైసీపీ ఉంది
the decision to be together	కలిసి
i dont believe anybody knows	నాకు నమ్మకం ఎవరూ
mla held on murder charge	హత్య కేసులో ఎమ్మెల్యే
five killed in us shooting	అమెరికాలో కాల్పులు ఐదుగురు మృతి
the test comprises three parts	పరీక్ష మూడు ఉంటుంది
other reasons can be	ఇతర మరియు సంబంధించిన కుటుంబం
he runs many educational institutions	పలు ఉన్నారు
but the farmers dont care	కానీ రైతులు చేసుకోవడానికి లేదు
the result is utter	ఫలితంగా పూర్తి నిరాశ ఉంది
nothing was heard nor uttered	చూడండి లేదా వినడానికి ఏదీ లేదు
thats the heaven on earth	ఇది
crore used to be allotted	కోట్లు మంజూరు చేసిందన్నారు
thats not true at all	అది ఎంత నిజం కాదు
his health condition is	అతని ఆరోగ్య పరిస్థితి ఉందన్నారు
vehicles stayed off the road	దీంతో రహదారిపై వాహనాలు
theres still time for ipl	ఐపీఎల్కు ఇంకా ఎంతో సమయం ఉంది
our aim is social justice	మన లక్ష్యం సామాజిక న్యాయం
by then it was pm	అప్పుడు సమయం రాత్రి ఈ ఒకటిన్నర ఎంత అనిపించింది
i was in a mess	అయ్యాను
cancer is a disease	క్యాన్సర్ అనేది
is the district headquarters	ఈ జిల్లా
the youths had consumed liquor	మద్యం తాగుతూ చేశారు
it doesnt on mood	అది మీద ఆధారపడి లేదు
the incident occurred on monday	ఈ ఘటన సోమవారం జరిగింది
the of difficulties orders	ఉత్తర్వులు
speaker in chair	స్పీకర్ కూర్చున్నారు
i did watch arjun reddy	అర్జున్ రెడ్డి చూశాను
hence love stories stay	అందుకే ఎప్పుడూ ఉంటాయి
is a rich country	నా దేశం దేశం
do you even need one	ఇది మీకు కూడా అవసరం కదా
first innings is over	దీంతో ఇంగ్లండ్ తొలి ఇన్నింగ్స్ ముగిసింది
it was not recognized internationally	ఇది అంతర్జాతీయంగా
use or coconut oil	ఆలివ్ లేదా వాడండి
avoid exercising after having meals	ల ఆహారం తీసుకున్న తరువాత వ్యాయామం అన్నది చేయకూడదు
moreover its fast as well	అదనంగా ఇది చాలా త్వరగా చేస్తాను
but the situation changed soon	కానీ కొద్ది పరిస్థితి నాటకీయంగా మారింది
the climate has changed	వాతావరణ చాలా మారిపోయింది
thereafter shah left for hyderabad	అనంతరం పవన్ హైదరాబాద్ కు బయలుదేరారు
but the decision was taken	అయితే తీర్మానాన్ని
think about it another way	మరొక
their number is more than	దాదాపు వీరి సంఖ్య లక్షల పైన
it is like a village	అమ్మ వంటిది
principal arrested for student	విద్యార్థిని ఫిర్యాదుపై ప్రిన్సిపాల్ అరెస్టు
it is an truth	ఇది సత్యం ఆ ప్రభావం
arun jaitley arun jaitley death	అరుణ్ జైట్లీ కన్నుమూత సంతాపం
why did he kill himself	ఎందుకు ఆత్మహత్య చేసుకుంది
but no inquiry was made	కానీ ఎలాంటి పరిశీలన
every role has a	ఇందులో ప్రతి ఒక్క రోల్ కు ఒక ఉంది
not good for bjps politics	బీజేపీ తీరు మంచిది కాదు
is it really gods	వాస్తవానికి దేవుని కూడా అదే కదా
ips officials transferred in ap	ఏపీలో భారీగా ఐఏఎస్ అధికారుల బదిలీలు
happy republic day to everyone	అందరికీ గణతంత్ర దినోత్సవ శుభాకాంక్షలు
ingredients for	కావాల్సిన పదార్థాలు
one of them is paddy	వాటిలో ఒకటి
g plus specifications features	జీ ప్లస్ ఫీచర్లు
it is a sheer	అదొక ఆనందం
several members spoke on it	ఈ సందర్భంగా పలువురు ఎంపీలు మాట్లాడారు
so it is very	కాబట్టి ఇది విశేష దుఃఖాన్ని
the first prize of rs	ప్రథమ రూ
it shot up by percent	రెట్లు పెరిగాయి
is being sold at rs	కు
he is a medical doctor	ఆమె డాక్టర్
no increase in bus	రైల్వే పెంచడం లేదు
want to get into politics	రాజకీయాల్లోకి
pnb loses in two days	కుంభకోణం నేపథ్యంలో పంజాబ్ నేషనల్ బ్యాంక్ షేర్ విలువ రెండు శాతం
why is the lockdown necessary	ఎందుకు అవసరం
the government has rs	గ్రామాల అభివృద్ధికి ఏడాది ప్రభుత్వం రూ
i dont know where yet	తెలియడం లేదు
am i not a lawyer	నేను కాదా
seeing them the accused fled	ఆమెను చూసిన పారిపోయారు
whats a president to do	మరి రాష్ట్రపతి
diesel prices are at rs	డీజిల్ రేటు లీటరుకు రూ
but the love died soon	కానీ ఆ తర్వాతే ప్రేమ అడ్డదారి
how much do you earn	ఎంత చేసుకుంటున్నారు
the two fall in love	ఇద్దరు ప్రేమలో మునిగి ఉన్నారు
producers sahu harish	నిర్మాతలు హరీష్ సాహు
umesh yadav took two wickets	ఉమేష్ రెండు వికెట్లు లభించాయి
thats a very sad situation	అది చాలా పరిస్థితి
srikanth is the director	ఈ చిత్రానికి శ్రీకాంత్ దర్శకత్వం
why is it so hot	ఇది వేడిగా ఉంటుంది
the state government gave rs	రాష్ట్ర ప్రభుత్వం మొక్కజొన్న కు రూ
it is good for health	ఇది అన్ని ఆరోగ్యానికి మంచిది
it should be completed by	వరకు పూర్తిగా ఉందన్నారు
karnataka releases water to telangana	ప్రవేశించిన కృష్ణా
he did not further explain	ఆయన
those guilty should be punished	నేరం చేసిన వాళ్లు శిక్ష
he did not return home	తిరిగి రాలేదు
temperatures hit degree celsius here	గాలి ఉష్ణోగ్రత డిగ్రీల
i know its a risk	ఉందని నాకు తెలుసు
thats the thing about him	అది తనకు సంబంధించిన అన్నది
i dont know his name	పూర్తి పేరు ఏమిటీ నాకు తెలియదు
are healthy and nutritious	రుచికరమైన మరియు ఆరోగ్యకరమైన ఉంది
it is not our needs	అది మన
doctors declared her brought dead	ఉన్నట్లు డాక్టర్లు నిర్ధారణ చేశారు
timely completion of projects	సకాలంలో ప్రాజెక్టుల ప్రణాళిక
the two vehicles	రెండు వాహనాలు అక్కడే నిలిచిపోయాయి
opposition leaders criticized the government	రాష్ట్ర ప్రభుత్వంపై విపక్షాలు తీవ్ర దిగుతున్నాయి
he reached home soon after	ఇల్లు
he claimed she was lying	తాను
candidates need to be	అభ్యర్ధులు డిగ్రీ కావాల్సి ఉంటుంది
his mobile phone didnt	తని ఫోన్
why do cats hate	ఎందుకు కుక్కలు పిల్లులు
enquired about his health condition	ఆరోగ్య పరిస్థితి
search file types or applications	లేదా
avoid sugar and	చక్కెర మరియు శుద్ధి తగ్గించండి
she is detailed and comprehensive	అతను అత్యంత సమగ్ర మరియు ఉంటుంది
do not your exercises	వ్యాయామం ఎక్కువ చేయొద్దు
if true details are shown	చూపుము
cpi national secretary d raja	సీపీఐ జాతీయ కార్యదర్శి డి రాజా
at times he questions himself	కూడా తనని తాను
he is not a	తాను రాజకీయాలు
the building was completely gutted	దాంతో భవన నిర్మాణం పూర్తిగా
new delhi bills worth rs	న్యూఢిల్లీ పెద్ద నోటు రూ
its not difficult to write	దాని కష్టం ఏమీ లేదు
in mumbai petrol cost rs	ముంబైలో లీటర్ పెట్రోల్ ధర రూ
others are going away abroad	మరికొందరు విదేశాలకు కూడా పరిస్థితి
repeat for the right leg	ఎడమ కోసం రిపీట్ చేయండి
brothers back in	ఐ
and the second is anxiety	మరియు రెండవ
indian films in pak	భారత
we are constantly in	మేం నిత్యం మునిగి
its not difficult to do	సిద్ధం కష్టం వుండదు
how did you romance her	మెను ఎలా అంటూ ప్రశ్నించింది
passengers too are being	అలాగే కూడా నానా అవస్థలు పడుతున్నారు
chandrababu meets bjp president	చంద్రబాబు భేటీ
theres a variety of films	మీరు చూడగలరు గా వివిధ రకాల సినిమాలు ఉన్నాయి
special thanks to the	ప్రత్యేక కృతజ్ఞతలు
subsequently he shifted to hyderabad	హైదరాబాదుకు బదిలీ అయ్యారు
ahmed nagar scheme	అహ్మద్ నగర్ పథకం
its not meant for kids	పిల్లలకు కాదు
it is all very natural	అత్యంత సహజంగా అన్ని
are you a music lover	మీరు సంగీత
nobody has seen it since	అప్పటి నుండి ఇప్పటి వరకూ ఎవరికీ కనబడలేదు
click here for the story	కథనం కోసం ఇక్కడ క్లిక్ చేయండి
every one has a name	ఒక పేరు అన్నారు
rs lakh sought in damages	రూ కోట్లకు నష్టం
i do not know exactly	సరిగ్గా తెలీదు ఇష్టం లేదు మరి
the sky was blue	నారింజ పండు రంగులో కనిపించింది
did you get it eventually	చివరికి
the countrys stock market	దేశీ స్టాక్ మార్కెట్
then he gave a rs	అనంతరం తన వద్ద రూ
two children received serious injuries	ఇద్దరు కొడుకులకు తీవ్ర గాయాలయ్యాయి
its a very good habit	చాల మంచి అలవాటు
i dont think about them	అనే విషయాలు నేను ఆలోచించడం లేదు
then he gave a rs	ఆపై ఇవ్వాల్సిన రూ
its a new ball wicket	ఇది కొత్త వికెట్
the nature is beautiful here	ఇక్కడ ప్రకృతి ఉంటుంది
he joined the bjp recently	తాజాగా ఆయన మళ్లీ బీజేపీ చేరారు
the operation was conducted successfully	ఆపరేషన్ సజావుగా జరిగింది
the movie starts off slowly	ఆ సినిమా చాలా స్లోగా రన్
couldnt get out of bed	మీద నుంచి
i liked it very much	నాకు చాలా బాగా నచ్చింది
the government rejected the offer	సంస్థ ఆఫర్ను చేసింది
however few actually use them	అయితే ఇప్పటివరకు దీన్ని చాలా తక్కువ మంది
umesh yadav took two wickets	మరో ఎండ్ లో యాదవ్ రెండు కీలక వికెట్లు తీశాడు
the house is very old	ఆ ఇల్లు చాలా వుంటుంది
how do i her	ఆమెను ఎలా
doctor killed in road mishap	రోడ్డు ప్రమాదంలో మృతి
it was approved by parliament	దీనికి ఆమోదం తెలిపింది
very pretty to look at	చూడటానికి చాలా అందంగా ఉంది
the law is as under	ఈ క్రింది విధంగా చట్టం మద్దతిస్తుంది
swamy on chariot	వాహనంపై స్వామి
hold for and repeat	రెప్స్ కోసం రిపీట్ చేయండి
so its hard to know	అందువల్ల దీన్ని కష్టం
how to reach the waterfall	జలపాతం ఎలా
the next step is forward	తదుపరి దశ ముఖం
here are the latest rates	రేట్లు ఇవే
the name should be new	టైటిల్ కొత్తగా ఉండాలి
petrol price cut by paise	పైసలు తగ్గిన పెట్రోల్ ధర నుంచి అమలు
new in s content	లో కొత్తగా విషయ
small and facilitation council	చిన్న మరియు సౌకర్యాల మండలి
the ankle is not broken	విరిగిన
fire breaks out in market	మార్కెట్లో అగ్ని ప్రమాదం
the other child is seven	రెండో ఏడు వచ్చింది
had many children	ఆ దంపతులకు స్వంత పిల్లలు లేరు
you can see it here	దానిని మీరు చూడండి
the political situation had changed	రాజకీయ పరిస్థితులు మారాయి
why should i settle down	నేనే ఎందుకు
it was a bit	దాంతో కాస్త తలెత్తింది
telangana boy killed in us	అమెరికా కాల్పుల్లో తెలంగాణ వ్యక్తి మృతి
the cbi denied the allegations	ఆయన ఆరోపణలు సిబిఐ కొట్టి
ram charan and jr ntr	సినిమాలో ఎన్టీఆర్రామ్ చరణ్
agriculture is in a mess	వ్యవసాయం అంటేనే
no space left on device	ఇంకా
restrictions down in kashmir	కశ్మీర్ లో ఆంక్షలు
how to remove stretch marks	ఎలా తొలగించడానికి ఎలా
woman falls off bike dead	బైక్ పై నుంచి యువతి మృతి
sbi is indias biggest bank	భారతదేశపు అతి పెద్ద బ్యాంక్ ఇపుడు పెద్ద కరెన్సీ రద్దు మార్పిడి వ్యవహారంతో డబ్బులు వచ్చి బ్యాంక్ లో డిపాజిట్
their condition is very serious	వారి ఆరోగ్య పరిస్థితి విషమంగా ఉంది
i can say no more	అయినా ఉండలేను
the films release was delayed	దీనితో చిత్ర విడుదల ఆలస్యం అయ్యింది
wish you all the best	అని అన్నారు
such opportunity wont come again	ఇలాంటి మంచి మళ్లీ రాదు
third time in a row	మూడోసారి పోటీపడుతున్నారు
fans love seeing her pictures	ఈ ఆమె అందాలు చూసి ఆమె అభిమానులు
it is very high cost	ఇది అధిక ధర
the others are all	ఇక మిగిలిన వారంతా కాంగ్రెస్ పార్టీకి చెందిన
it is easy to know	తెలిసేది
why do you say so	మరి అంత చెప్పడానికి కారణం
a vacation home in goa	ఇన్ గోవా
no changes in tax rate	ఆదాయం ఎలాంటి మార్పు చేయలేదు
havent you seen the movie	సినిమా
the article is very	వ్యాసం ఎంతో
whats in store for men	పురుషుల గురించి వాస్తవాలు ఏమిటి
you need to eat right	మీరు కుడి తినడానికి అవసరం
tdp lost a senior leader	సీనియర్ నేత అవుట్
party does not accept it	దానికి పార్టీ తీసుకోలేదు
its not the hands	చేతులు కాదు
refer to the table below	దిగువ పట్టిక చూడండి
need to change the practice	మార్పులు అవసరం
the ship stopped just short	అప్పుడే పడవ వచ్చి ఆగింది
oil prices could drop	ముడి చమురు ధరలు భారీగా పతనం
boosts immunity in the body	శరీరంలో రోగనిరోధక శక్తిని పెంచుతుంది
the death toll climbed to	మరణాల సంఖ్య కి పెరిగింది
cultivation is especially common	తాజా పుస్తకం
in the coalition government	సంకీర్ణ
go and search for it	వెళ్లి అడిగి చూడు
how was the casting done	ఎలా జరిగింది
it is quite comfortable here	ఇక్కడ హాయిగా కూడా
couple killed in road mishap	దారుణం రోడ్డు ప్రమాదంలో మృతి
recently however another problem has surfaced	అయితే తాజాగా మరో వెలుగు చూసింది
the movie is helmed by	ఈ సినిమాకి దర్శకత్వం
her assets amounts to rs	ఈమె సంపద విలువ రూ
he can change his stand	అతను ఏ సమయంలో తన నిర్ణయాన్ని
everyone knows how great he is	ఆయన వ్యక్తిగా ఎంత అందరికీ తెలుసు
in short the perfect job	ఒక్క చెప్పాలంటే పర్ఫెక్ట్ ఇటాలియన్ జాబ్
the positivity rate stands at percent	వాటా శాతంగా నమోదైంది
a museum is being built too	అలాగే కూడా ఒక మ్యూజియం ఉంది
i for a few moments	కొద్ది క్షణాలు
ive never met anyone like him	తను అలా ఎవరితోనూ కలవడం నేను చూడలేదు
in america the vote is sacred	అమెరికాలో ఓటు చాలా పవిత్రమైంది
two children died in the incident	నీటిలో మునిగిన ఇద్దరు పిల్లలు మృతి చెందారు
tell the truth to the people	వాస్తవాలు చెప్పాలి
of is not necessary	ఆధార్ లింక్ కూడా చేయక్కర్లేదు
wish you good health and happiness	మీరు కోరుకుంటున్నా
do not go to crowded places	రద్దీ ఎక్కువగా ఉన్న ప్రదేశాల్లో ఉండకూడదు
the is simple yet	స్టోరీ లైన్ గా ఉన్నా ఆసక్తికరంగా ఉంది
goa cm passes away	గోవా సీఎం మనోహర్ కన్నుమూత
she has husband and two children	భార్య కుమారుడు ఉన్నారు
the population of mali is million	ఈ జనాభా మిలియన్ల మంది ఉన్నారు
it makes no impact on result	దీని ద్వారా ఎటువంటి ప్రభావం ఉండదు
we dont shoot in the dark	మాకు పనిలేదు
the situation is getting worse	దీంతో పరిస్థితి మరింత తీవ్రంగా మారుతోంది
things needed to make the	పానీయం తయారీకి
but he didnt come back home	కానీ ఇంటికి తిరిగి సజీవంగా రాలేదు
i just loved a wild	ఒక
it inspired art music films sport	సంగీతం క్రీడలు సినిమాలు రచనలు వంటి ప్రధాన సైతం ప్రభావితం చేశారన్నారు
rashid khan afghanistan vs west indies	రషీద్ ఖాన్
best actor kapoor	కపూర్ ఉత్తమ నటి
vs december pm ist	లీ వర్సెస్ డిసెంబర్ సాయంత్రం గంటలకు
add a little water if required	అవసరం కొద్దిగా నీరు
the school was a bad place	ఉండేది
its very much a communication	ఈ అంత అవసరం కమ్యూనికేషన్ పరికరం
its not going to be quick	ఇది వేగవంతం లేదు
a total price money of rs	గ్రా వెండి కలిపి మొత్తం విలువ రూ
theres nothing to be afraid of	ఇందులో ఏమీ లేదు
how to plant saplings at home	ఎలా ఇంట్లో ఒక చెట్టు పెరగడం
episode the red team weighs in	జనవరి ఆంధ్ర ప్రదేశ్లో రాష్ట్రపతి పాలన
president obama arrives in saudi arabia	అమెరికా అధ్యక్షుడు బరాక్ ఒబామా చేరుకున్నారు
the people in large number	దీన్ని నిరసిస్తూ ప్రజలు భారీ ఎత్తున నిరసన తెలిపారు
are you taking steps towards it	మీరూ ఆ దిశగా
happy to be home he added	సొంత ఆనందంగా ఉంది అని ప్రకటించారు
five people died on the spot	దాంతో ఐదుగురు అక్కడికక్కడే మృతి చెందారు మరో
the skin appears and cleaner	చర్మం తాజాగా మారుతుంది
how much storage do i need	ఎంత ఐప్యాడ్ నిల్వ అవసరం
slowly love between the two	ఈ ఇద్దరి మధ్య ప్రేమ
but the project has not	అయితే ఏళ్లు ఆ ప్రాజెక్ట్
suicide in and young adults	పిల్లలు మరియు కౌమారదశలో ఆత్మహత్య
later he addressed a news conference	అనంతరం విలేకరుల సమావేశంలో ఆయన మాట్లాడారు
a was filed in court	కోర్టులో దాఖలు చేశారు
mumbai wedding reception see	ముంబైలో ప్రియాంక నిక్
it is very exciting and interesting	ఈ చాలా ఆసక్తికరమైన మరియు ఉంది
lets look at some of these	అటువంటి కొన్ని చూద్దాం
bjp in wait and watch mode	బీజేపీ
the child died the next day	మరుసటి రోజున బిడ్డ మృతి చెందింది
but modi failed to do so	కానీ అలా మోడీ మోసం చేశారని
to which he responded on twitter	అంటూ ట్విట్టర్ లో స్పందించారు
two arrested for stealing	ఇద్దరు అరెస్ట్
the satellite launch vehicle	శాటిలైట్ లాంచింగ్
malaria is by infected	ద్వారా మలేరియా
however her presence isnt yet	అయితే ఈయన ఇంకా ఖరారు కాలేదు
has three daughters and a son	ఒక కూతురు కొడుకు
the other technical aspects are	ఇతర టెక్నికల్ విభాగాల విధంగా ఉంది
or isnt he the real one	లేక అసలు లేదా
england won the cricket world cup	జరిగిన ప్రపంచ కప్ ద్వారా ఇంగ్లాండ్ నిలిచింది
i dont know about the rest	మిగిలిన సంగతి నాకు తెలియదు
telangana protest continues on day two	రెండో రోజూ కొనసాగుతున్న తెలంగాణ బంద్
expected an but found s	అయితే
the duo two wickets each	వికెట్ చొప్పున రెండు వికెట్లు తీశారు
to the point of open	ఇది అధికం
several others are doing the same	మంది కూడా అదే దారిలో వున్నారు
then why has food inflation	ఆహార మాత్రం ఎందుకు
how to choose the right one	ఎలా కుడి పండు ఎంచుకోవడానికి
symptoms and treatments of breast cancer	క్యాన్సర్ దాని లక్షణాలు మరియు చికిత్సలు
and teachers are not the problem	శ సమస్యలు ఉపాధ్యాయులు అవి కావు
it is however his personal opinion	అయితే ఇది తన వ్యక్తిగత అభిప్రాయం మాత్రమేనని ఆయన చెప్పడం విశేషం
another record in history of medicine	మరో రికార్డు
bjp is a part of us	మేమూ బీజేపీ
woman dies due to electric current	షాక్ మహిళ మృతి
stay out of the danger zone	నుండి దూరంగా ఉండండి
but heres where it gets	కానీ ఇక్కడ అది కష్టం హక్కును కలిగి ఉంది
security forces on duty in kashmir	కశ్మీర్ లోయలో భద్రతా బలగాలు
she didnt speak for a while	చాలా సేపు అతడు ఏం మాట్లాడలేదు
im ready to be a dad	మొత్తానికి నేను తండ్రిని
award for amitabh bachchan	పురస్కారం
jana sena party chief pawan kalyan	జనసేన పార్టీ అధినేత పవన్ కల్యాణ్ ఓ అడుగు
keep your arms to the side	చేతులను ఉంచండి
you can use the app to	ఇక్కడ మీరు ఉపయోగించవచ్చు
how do you select the stories	ప్ర మీరు ఎలా ఎంపిక చేసుకుంటారు
he later became a software engineer	వేర్ తర్వాత నటుడిగా
but everybody had heard of it	కానీ అందరూ ఆయన్ని చాలా
so i went to the hospital	అందుకే ఆస్పత్రికి వెళ్లాను
here are the videos and pictures	ఆ ఫోటోలు
she was admitted at a hospital	ఆమెను ఆసుపత్రిలో
passengers face a lot of problems	ప్రయాణికులు అనేక ఇబ్బందులు సందర్భాలు వున్నాయి
but state did not accept it	అయితే రాష్ట్ర ప్రభుత్వం
it is a very tasty	ఈ చాలా రుచికరమైన వంటకం
the meeting was chaired by sarpanch	సర్పంచ్ అధ్యక్షతన జరిగిన సభ జరిగింది
party leaders organised blood donation camps	పార్టీ నాయకులు ఏర్పాటు చేశారు
the karnataka assembly is member strong	కర్ణాటక అసెంబ్లీలో మంది సభ్యుల సంఖ్య
the bjp is in serious crisis	రాష్ట్రంలో బీజేపీ తీవ్ర
he told me about their	వాళ్ళ గురించి చెప్పాడు
then the government took the decision	సంచలన నిర్ణయం తీసుకుంది
tiger one just got hit	వన్
im born and raised in chennai	నేను అయినా
results are yet to be declared	ఫలితాలు ఇంకా విడుదల కావాల్సి ఉంది
he later addressed the media persons	తర్వాత ఆయన మీడియాతో మాట్లాడారు
in our country it is worse	మన దేశంలో మాత్రం పరిస్థితి దారుణంగా తయారైంది
the virus does not affect everybody	వైరస్ ప్రభావం ఒకే మాదిరిగా ఉండదు
it is at a week low	ఇది వారాల స్థాయి
in politics anything can happen	రాజకీయాల్లో ఎప్పుడు ఏమైనా తప్పదు
dhoni is a big big player	ధోనీ అద్భుత ఆటగాడు
currently she has films on hand	ఇప్పటిదాకా సినిమాలు చేశా
security up in the state	రాష్ట్రంలో పటిష్టం చేశాం
all the other players are new	మిగతా వారంతా యువ
it is directed by rohit shetty	ప్రముఖ దర్శకుడు రోహిత్ శెట్టి దీన్ని రీమేక్ చేస్తున్నాడు
three soldiers killed in pakistan	పాక్ కాల్పులు మృత సైనికుడు
he had no interest in studies	అస్సలు ఆసక్తి ఉండేది కాదు
it has and antiinflammatory properties	ఇందులో యాంటీ ఇన్ఫ్లమేటరీ మరియు లక్షణాలు పుష్కలంగా ఉన్నాయి
stay positive and enjoy your life	సానుకూలంగా జీవితాన్ని ఆనందంగా అలవాటు చేసుకోవాలి
it has to be	ఇది విడిగా కొనుగోలు ఉంటుంది
unable to get notification for	కొరకు పొందలేము
banking financial services and insurance	ప్రధానంగా బ్యాంకింగ్ ఫైనాన్షియల్ ఇన్సూరెన్స్
terrorism is the enemy of humankind	శత్రువు అని అన్నారు
at last she won her battle	చివరికి ఆ ఆమెనే గెలిచింది
supreme court chief justice ranjan	వీటిని సుప్రీం కోర్టు చీఫ్ జస్టిస్ రంజన్ విచారణ చేశారు
family members of the deceased	నిరాహార దిగిన బాధిత కుటుంబ సభ్యులు
expect an addition of approximately rs	ఫియట్ దాదాపుగా రూ
these cause a number of diseases	ఇవి అనేక రకాలైన
pawan tour hits a	పవన్ కళ్యాణ్ పర్యటన అంతా గప్చుప్గా
it provides to the skin	చర్మానికి అందిస్తుంది
i was transferred to another station	నాకు వేరే బదిలీ అయ్యింది
give enough time to each subject	అన్ని తగినంత సమయం
norway and switzerland their	డిసెంబర్ మరియు ప్రారంభించాయి
actress was the	హీరోయిన్గా నటించింది
the of rest is	మిగిలినవి లు
an official announcement was made recently	క్రితం అధికారిక ప్రకటన విడుదల చేశారు
people concerned about rising corona cases	కరోనా కేసులు ఆందోళన
i take as an actor	నటుడిగా నన్ను నేను అన్నారు
nobody spoke for quite a while	చాలా కాలం వరకు ఈ విషయమై ఎవరికీ కూడ చెప్పలేదు
however the government has not responded	అయినా తమిళనాడు ప్రభుత్వం సమాధానం ఇవ్వలేదు
duty on fuel up	శాతం పెంపు
virat kohli is an exceptional leader	విరాట్ కోహ్లీ ఓ అసాధారణ కెప్టెన్
same is the case here too	ఇక్కడ కూడా అదే
general and candidates rs	లోక్సభ పోటీ చేసే జనరల్ అభ్యర్థులు రూ
many people dont know the reality	చాలామందికి అసలు తెలియదు
ravinder was injured in the incident	ఈ ఘటనలో తీవ్ర గాయాలయ్యాయి
motorcycle theft gang two held	చోరీ ముఠా అరెస్టు
we need to explore the opportunities	అవకాశాలు మనం
former un secretary general	ప్రపంచం సమితి మాజీ సెక్రటరీ జనరల్ మృతి
do something youve never done before	మీరు ముందు ఎన్నడూ చేయండి
the total number of seats is	మొత్తం సీట్లు ఉన్నాయి
she acted in hindi movies too	ఆమె కన్నడ సినిమాల్లో కూడా నటించారు
looking for something yet	కొంచెం ఆధునిక ఏదో కోసం
music by vivek sagar is outstanding	వివేక్ సాగర్ సంగీతం
courageous through faith and fear	విశ్వాసం మూలంగా ధైర్యంగా ఉండడం
boy falls into water tank dies	పడి చిన్నారి మృతి
it improves and reduces constipation	మెరుగుపరుస్తుంది
it is available in two options	ఇక్కడ ఇది రెండు రకాల అందుబాటులో ఉంది
true as far as i know	నాకు వరకు ఇది నిజం
she then called up her husband	అనంతరం తన భార్యకు ఫోన్ చేశాడు
who is up for a competition	అక్కడ ఎవరు పోటీ
how to reduce stress during pregnancy	ఒత్తిడి
the news triggered panic among villagers	దీంతో ఈ వార్త అక్కడి
the incident took place in delhi	దేశ రాజధాని దిల్లీలో ఈ కార్యక్రమం
these antioxidants protect against cell damage	ఇక కణాలు
whats new to watch out for	మళ్ళీ కొత్తగా
the boat broke in the water	దీంతో బోటు సముద్రంలో మునిగిపోయింది
the cemetery boundaries are unchanged since	నుండి మాండ్య జిల్లాలోని స్థిరంగా ఉన్నాయి
bangladesh arrests mastermind of murders	బంగ్లాదేశ్ దారుణ హత్య
the benefits of exercise during pregnancy	అప్పుడు చేసే వ్యాయామం వల్ల కలిగే అద్భుత ప్రయోజనాలు
its simple and easy to use	వాటిని ఉపయోగించి చాలా సాధారణ మరియు సౌకర్యవంతంగా ఉంటుంది
the second game was more thrilling	రెండో గేమ్ సైతం ఉత్కంఠ సాగింది
people gathered near the accident spot	జరిగిన ప్రదేశంలో జనం
dil raju is the films producer	దిల్ రాజు ఈ సినిమాకి నిర్మాతగా వ్యవహరిస్తున్నాడు
i talk of social and political issues	సామాజిక అంశాలు రాజకీయాలు
theyve done great service for the team	చాలా సేవ చేశా
since then the case has remained	అప్పటి నుంచి కేసు స్టే మీదే నిలిచిపోయింది
ram gopal varma is a happy man	రామ్ గోపాల్ వర్మ ఆనందం
in ideal conditions it very fast	అనువైన పరిస్థితులలో చాలా వేగంగా ఉంటుంది
but not everything is as it seems	కానీ అన్నీ కదా
part of the upper time limit	ఎగువ సమయ పరిమితి యొక్క భాగము
im a daughter of an army officer	నేను ఓ ఆర్మీ అధికారి భార్యను
not a bit of it is true	ఇందులో కాస్త నిజం లేకపోలేదు
but it was not implemented till date	కానీ అది ఇప్పటి వరకు ఆచరణ సాధ్యం కాలేదు
pakistan releases video of downed iaf pilot	పాక్ ఉన్న భారత వీడియోలు పోస్ట్
trs gets majority in telangana assembly elections	తెలంగాణ అసెంబ్లీ ఎన్నికల టీఆర్ఎస్ పార్టీ స్పష్టమైన
here are things to keep in mind	ఇక్కడ విషయాలు ఏంటంటే
has four sons and a daughter	భార్య నలుగురు సంతానం ఉన్నారు
risk factors and causes of ovarian cancer	కారణాలు మరియు ప్రమాద కారకాలు
the movie is being produced in bollywood	ఇప్పుడు ఓ సినిమా చేస్తున్నారు
how does it compare to other states	ఇతర ఎలా
such a system needed to be changed	ఇలాంటి వ్యవస్థ
it is only some ha in area	అందులో కవితా కూడా ఉన్నాయి
store the liquid in a cool place	చల్లని ప్రదేశంలో పానీయం ఉంచండి
the bharatiya janata party opposed the resolution	ఈ నిర్ణయాన్ని భారతీయ జనతా పార్టీ
these cause to commuters and passengers	దీంతో ప్రయాణికులు ప్రజలు ఇబ్బందులు పడుతున్నారు
it is being by some people	దీన్ని కొంత మంది చేస్తున్నట్లు తెలుస్తోంది
we want the guilty to be punished	మేం
tdp leaders attacked ysr congress party leaders	ఈ విషయమై టీడీపీ నాయకులు నేతలతో దిగారు
however it doesnt get any mechanical changes	అయితే మెకానికల్ గా ఎలాంటి చేయలేదు
so i got admitted to the hospital	అందుకని ఆస్పత్రిలో చేరాను
he died during treatment at the hospital	ఆ హాస్పిటల్లో చికిత్స మరణించాడు
then rinse them well and dry	అప్పుడు వారు ప్రక్షాళన చేయాలి మరియు
however the court had dismissed the plea	అయితే జగన్ పిటీషన్ ను కోర్టు
you cant take decisions on your own	సొంతంగా నిర్ణయాలు
trs announces candidates for rajya sabha elections	టీఆర్ఎస్ రాజ్యసభ అభ్యర్థులు ఖరారు
it is a great opportunity for him	ఇది గొప్ప పేర్కొన్నారు
we should help them secure these rights	అటువంటి సహాయం అందించే
robert vadra appears before ed for	ఈడీ ముందు రాబర్ట్ హాజరు
shes undergoing treatment at a local hospital	బాధితుడు జిల్లా చికిత్స
he still has a lot to learn	తను ఇంకా చాలా ఉంది అని చెప్పారు
sometimes it can even lead to death	అంతే కాకుండా కొన్ని సందర్భాల్లో అది మరణానికి కూడా దారి
as a result some to	కొంతమంది
the causes can be permanent or temporary	లేదా శాశ్వతంగా ఉంటాయి
praise yahweh jerusalem praise your god	యెహోవాను నీ దేవుని
put your mind in devotion to god	మనసును
he was to the third place	పడిపోయింది
however detailed investigation was still going on	కానీ మరింత వివరంగా అధ్యయనం ఇప్పటికీ కొనసాగుతోంది
the death toll is likely to increase	మృతుల సంఖ్య పెరిగే రు
the megapixel camera can take quick shots	మెగా అదిరిపోయే విధంగా ఫోటోలు
she posted the video on social media	ఈ వీడియో తీసి సోషల్ మీడియాలో
how did you get into the movies	సినిమాల్లో పాడే అవకాశం ఎలా వచ్చింది
but it isnt just the centre alone	అయితే కేంద్రం ఒక్కటే చొరవ కాదు
vijay is a really good actor	విజయ్ ఒక నటుడు
his death has left the family shattered	ఈ మృతి తమ కుటుంబాన్ని తీవ్ర
music is delivered by devi sri prasad	మ్యూజిక్
but he did not agree to it	కానీ ఆ విషయాన్ని ఆయన
bjp suffers defeat in karnataka polls	కర్ణాటకలో బీజేపీకి ఓటమి భయం
he was taking aim at the bjp	ఆయనను బీజేపీ టార్గెట్ చేసింది
selling pressure was in all stocks	అన్ని అమ్మకాల ఒత్తిడి కనిపించింది
the entire incident was recorded in cctv	ఈ సంఘటన మొత్తం లో అయ్యింది
the incident took place in uttar pradesh	ఉత్తరప్రదేశ్ రాష్ట్రంలో ఘటన
our economic condition has improved a lot	మన ఆర్థిక స్థితి అని వ్యాఖ్యానించారు
he died on to the hospital	ఆసుపత్రికి తరలిస్తుండగా మృతి చెందాడు
received several accolades particularly for chopra	అనేక చోట్ల ప్రశంసలు అందుకున్నారు ముఖ్యంగా
avoid short and tight and	దుస్తులు మరియు
madras high court case against rajinikanth	రజనీకాంత్ భార్యకు ఇచ్చిన మద్రాస్ హైకోర్టు
due to blast the house caught fire	పేలుడు
a fight broke out between the two	ఇద్దరి మధ్య పెద్ద జరిగింది
people injured as bus falls into pit	అదుపుతప్పి బోల్తా బస్సు మందికి గాయాలు
it is being directed by rahul	రాహుల్ దర్శకత్వంలో శ్యామ్ అనే సినిమా చేస్తున్నాడు
pawan kalyan stages performances under chandrababus direction	చంద్రబాబు డైరెక్షన్లో నటిస్తున్న పవన్ కళ్యాణ్
later he got married to another woman	తర్వాత మరో అమ్మాయిని పెళ్లి చేసుకున్నాడు
public was suspended across the city	ప్రజా రవాణా నిలిచిపోయింది
you new friends along the way	కొత్త మిత్రులతో పెరుగుతాయి
it makes the skin and beautiful	ఇది చర్మాన్ని గా మరియు గా
thank you for making us sir	మమ్మల్ని చేసినందుకు ధన్యవాదాలు సింధు అని ట్వీట్ చేశారు
microsd cards up to gb are supported	జీబీ వరకూ మెమొరీ
more details about the incident are awaited	ఈ సంఘటనకు సంబంధించి మరిన్ని వివరాలు
he wrote songs for more than films	కి పైగా చిత్రాలకు నేపథ్య సంగీతాన్ని ప్రోగ్రామ్ చేశాడు
in their book the privileged	ద అనే తమ పేర్కొన్నారు
if not then it should be dropped	అలా
he often shares his photos on instagram	ఐతే తన ఫోటోలను మాత్రం లో ఉంటుంది
the cause of the accident wasnown	ప్రమాదం గల కారణాలు తెలియరాలేదు
but we arent in the clear yet	అయితే మేము ఇంకా స్పష్టంగా
it can eyes and	ఇది కళ్ళు గొంతు చర్మానికి కలిగించవచ్చు
but i am working on it	కాని దాన్ని అధిగమించడానికి ప్రయత్నిస్తూనే ఉన్నాను
but doctors had advised them against it	కానీ వైద్యులు హెచ్చరించారు
two singles off the first two balls	తొలి రెండు బంతుల్లో రెండు సింగిల్స్ ఇచ్చాడు
other states too must follow the same	మిగిలిన రాష్ట్రాలు కూడా ఈ దారిలోనే
thats why it came out so well	అందుకే మంచి వచ్చింది
her personal life was an one	ఈమె వ్యక్తిగత జీవితం మాత్రం
should be mothers milk	చిన్న పిల్లలకు తల్లి పాలు తప్పనిసరిగా
i would again say the same thing	నేను మళ్లీ అదే మాట చెబుతాను
fans wait for the match to start	షో ఎప్పుడు ప్రారంభం అని ఎదురుచూస్తున్నారు అభిమానులు
it is has another benefit as well	దీనివల్ల ఇంకో వుంది
technology santosh kumar district	టెక్నాలజీ సంతోష్ కుమార్ జిల్లా
the bus rammed into the road	బస్సు ప్రమాదంలో
the doctors are saying she is	వారు తెలిపారు డాక్టర్లు
telugu is the main language spoken here	ఇక్కడ అత్యధికంగా మాట్లాడే మైనారిటీ భాష తెలుగు
the dream was not easy to realize	ఆ కల కూడా అంత తేలిగ్గా
he has a son and a daughter	కుమార్తె కుమారుడు ఈయనకు సంతానం
how did daniel jehovahs spirit domain	ఒక
courtesy the late show host stephen	టాక్ షో హోస్ట్ స్టీఫెన్
the ball goes to the quickly	బంతి వేగంగా
the decision was taken by the cabinet	కేబినెట్లో మాత్రం నిర్ణయం తీసుకున్నారు
again its a matter of personal choice	కానీ మళ్ళీ ఇది వ్యక్తిగత ఎంపిక యొక్క విషయం
it offers gb ram and gb storage	జీబీ వరకు ర్యామ్ జీబీ వరకు స్టోరేజ్ ఇందులో కూడా ఉన్నాయి
why because the know the language	ఎందుకంటే ఆ తెలుగు
main accused of murder case	ప్రణయ్ హత్య కేసులో అరెస్ట్
once it has cooled keep in refrigerator	డిష్ డౌన్ శీతలీకరణ తరువాత అది లో
he can get emotional rather easily	చాలా సున్నితంగా అంటే అనిపిస్తుంది
hyderabad to emerge as defence hub	రక్షణ కేంద్రంగా హైదరాబాద్
he is a graduate of harvard university	ద హార్వర్డ్ విశ్వవిద్యాలయం యొక్క ఒక
kl rahul has got huge batting talent	కేఎల్ ఉంది
it is low in calories and fat	ఇది ఒక తక్కువ పోషక విలువ మరియు కొవ్వు తక్కువగా ఉంది
he had played matches for indian team	తన అతను ఇంగ్లాండ్ జాతీయ జట్టు కేవలం మ్యాచ్లు ఆడాడు
however congress leaders the bjp claims	మరోవైపు బీజేపీ చేస్తున్న వ్యాఖ్యలపై కాంగ్రెస్ నేతలు కూడా ఎదురుదాడికి
the temperature of water	ఉప్పు స్థానం నిరాశ ద్వారా నీటి స్థానం
it the gdp of many countries	ఇది చాలా దేశాల జీడీపీ కంటే ఎక్కువ
its a good long term investment plan	మంచి ఇచ్చే ఇది
the scene was caught on cctv cameras	ఈ దృశ్యాలు అక్కడి సీసీటీవీ రికార్డు అయ్యాయి
but the marriage hasnt taken place yet	అయితే పెళ్లి ఇంకా కాలేదు
it is easy to dismantle and	వారు సులువుగా మరియు భాగాలను ఉన్నాయి
check out more details within the article	మరింత సమాచారం చూడవచ్చు
however both the films didnt well	ఐతే చిత్రాలు అనూహ్యంగా పరాజయం చవిచూశాయి
another case was pending in the court	మరో వైపు కోర్టు లో కేసు నడుస్తోంది
gst affected and	జీఎస్టీ వల్ల వ్యాపార వర్గాలకు చిన్న తీవ్రమైన నష్టం అన్నారు
as a result the situation became chaotic	దీంతో పరిస్థితి గందరగోళంగా మారింది
a situation prevailed in the area	దీంతో ఒక్కసారిగా ఆ ప్రాంతంలో వాతావరణం నెలకొంది
three of them are in critical condition	వీరిలో ముగ్గురి పరిస్థితి విషమం
shares close to in early trade	అన్ని కూడా దాదాపు శాతం వరకు లాభపడ్డాయి
dont sit next to them on flights	విమానాలు వారి పక్కన
devi sri prasad has rendered the music	ప్రసాద్ అందించారు
why are we it so much	మరి అంత భయం భయంగా రాయడం ఎందుకు
the incident took place near kerala	ఈ ఘటన చోటు చేసుకుంది
it is better to completely avoid alcohol	మద్యం పూర్తిగా ఉత్తమం
humans use building materials to	నిర్మాణ వాడి
four killed in road accident in kurnool	కర్నూలు జిల్లాలో రోడ్డు ప్రమాదం ఆరుగురు మృతి
he gave runs in his four overs	తన తర్వాతి రెండు ఓవర్లలో కలిపి పరుగులు
lakh to the chief ministers relief fund	లక్షలు ఏపీ ముఖ్యమంత్రి సహాయనిధికి అందించారు
rich life in jehovahs service r	ముఖ్యమైన
atal was one of them	వారిలో అటల్
i knew her through a common friend	ఆయన ఒక కామన్ ఫ్రెండ్ ద్వారా కలిశాను
eventually the movie was ready for release	ఎట్టకేలకు మూవీని చేశారు
he died at the age of	ఆయన తాగి తాగి ఏళ్ల చనిపోయారు
indias capacity potential and energy are	వనరులు సామర్థ్యం శక్తి భారత్ కాదని చెప్పారు
its the same in a family too	కుటుంబ వీరికి
the resolution was however defeated by one vote	కానీ కేవలం ఒకే ఒక్క ఆ ప్రతిపాదన
the move however was opposed by the bjp	అయితే బీజేపీ జార్ఖండ్ విభాగం ఈ చర్యను ఖండించింది
more information is available in the detailed report	దోషము
he later tried suicide by drinking poison	అనంతరం వెంట తెచ్చుకున్న మందు తాగి ఆత్మహత్యకు
it has a tennis court and basketball ground	టెన్నిస్ మరియు క్రీడా పార్క్ ఉంది
the restaurant is open only in the evening	ఆన్ సైట్ రెస్టారెంట్ వరకూ ఉంటుంది
channel count changes may produce audio	లెక్కింపు మార్పులు ఆడియో ఉత్పత్తి చేయవచ్చు
you can try out some other options too	కొన్ని ఎంపికలు మీరు
it helps to remove in the body	అదే సమయంలో శరీరంలోని ను తొలగించడానికి సహాయపడుతుంది
the deceased include two women and two children	మృతుల్లో ఏడుగురు మహిళలు ఇద్దరు పిల్లలు ఉన్నారు
the objective was to avoid their development	వారి దాని ఉద్దేశం
it went on to become a best	ఇది ఒక బెస్ట్ మారింది
it was handed over to forest department officials	అటవీ అధికారులకు అప్పగించారు
later on he was seen in various films	ఆ తర్వాత ఈ సినిమాల్లో ఆయన కనిపించాడు
security forces put up a lot of efforts	ముమ్మరంగా గాలింపు చర్యలు
mohammad son to marry sania sister	అజారుద్దీన్ సానియా మీర్జా పెళ్లి
price rs lakh to rs lakh delhi	లక్షలు రెండు ధరలు ఎక్స్ షోరూమ్ ఉన్నాయి
we try to work to get the goals	ఇక లక్ష్యాలను కృషి చేస్తాం
it was then the incident came to light	దాంతో సంఘటన వెలుగులోకి వచ్చింది
blog doing any good for internet	బ్లాగులు మేలు
home national for congress in karnataka bypolls	జాతీయం కర్ణాటకలో ఎన్నిక వాయిదా
the driver was not injured in the accident	కాగా డ్రైవర్ ఎలాంటి గాయాలు కాలేదు
are rich in iron and vitamin	ఐరన్ మరియు విటమిన్ లు అధికంగా ఉంటాయి
he entered the house and raped the girl	బాలిక పై ఆమెను బెదిరించి అత్యాచారానికి పాల్పడ్డాడు
but delhi voters are not impressed at all	అయితే ఢిల్లీ ఓటర్లు ఓటింగ్ వేయడానికి పెద్దగా ఆసక్తి పోవడం విశేషంగా చెప్పుకోవచ్చు
no law and order in the state	సమాజంలో న్యాయం చట్టం ఏవీ లేవు
another criminal a at his head	మరో గురి పెట్టాడు
a bjp mla in up raped a woman	ఉత్తరప్రదేశ్లో ఒక బీజేపీ ఎమ్మెల్యే ఒక బాలికపై అత్యాచారానికి
earthquake hits southern california second in two days	భారీ భూకంపం రెండు తర్వాత తీవ్రస్థాయిలో
thus began a new chapter in his life	అందువలన అతను తన ఒక కొత్త పేజీ
in indian won medals	ఆసియా భారత్ మొత్తం పతకాలు గెలవగా అందులో బంగారు పతకాలు ఉన్నాయి
but he is a man in a hurry	కానీ బొత్తిగా మనిషి
three passengers suffered minor injuries in the incident	ఈ ఘటనలో ముగ్గురు
in the ancient games champions enjoyed widespread	పొందవలెనని గురి
global tenders upto rs crores to be	గ్లోబల్ అవకాశం లేదు
the measured on the richter scale	రిక్టర్ స్కేల్పై భూకంప తీవ్రత గా నమోదయింది
icici bank launches credit and debit cards	ఐసీఐసీఐ మరో ప్రయోగం క్రెడిట్
republic day celebrations pass off peacefully in kashmir	లో ప్రశాంతంగా వేడుకలు
the bill was approved by the lok sabha	దీంతో బిల్లు లోక్ సభ ఆమోదం ప్రకటించారు
but the congress had opposed the idea	అయితే రేవంత్ కాంగ్రెస్ లోనే ఓ తీవ్రంగా
thoughts on the allnew hyundai i premium hatchback	కొత్త తరం హ్యుందాయ్ ఐ డ్రైవ్స్పార్క్ అభిప్రాయం
every family has an old tradition of cooking	ప్రతి కుటుంబం ఒక సృష్టి ఉంది
subjects physics biology economics psychology mathematics	విభాగాలు ఫిజిక్స్ జువాలజీ తెలుగు కంప్యూటర్ సైన్స్ హిందీ
she began writing poetry at a young age	ఆమె చిన్న వయస్సులోనే కవిత్వం రాయడం ప్రారంభించింది
the fire are the flames	సిబ్బంది మంటలను
last date for withdrawal of is november	దరఖాస్తులకు చివరితేదీ నవంబర్
is a chronic disease of the airways	అనేది ఊపిరితిత్తుల వాయు వ్యాధి
google youtube for spreading	సెర్చ్ ఇంజన్ గూగుల్ యూట్యూబ్
it has antibacterial antioxidant antifungal and antiinflammatory properties	ఇందులో యాంటీ యాంటీ యాంటీ బ్యాక్టీరియల్ యాంటీ వైరల్ యాంటీ
bajaj all up for the wedding	పెళ్లి బజాజ్
i take care of my fitness every day	రోజూ ఫిట్నెస్ మీద శ్రద్ధ
i never believed i was one of them	నేను అలాంటి వారిలో ఎప్పుడూ అనుకోలేదు
nobody knows how big the impact could be	ఆ ప్రభావం ఎవరికీ తెలియదు
since then indias population has more than	అప్పటి నుంచి అక్కడ చెందిన జనాభా కూడా పెరుగుతూ వచ్చింది
the incident took place in west godavari district	పశ్చిమ గోదావరి జిల్లా ఈ సంఘటన చోటు చేసుకుంది
farmers are frustrated over the of prices	నిలకడ లేని రైతులు
paul to see how god strengthened him	దేవుడు తనను ఎలా చూసినప్పుడు పౌలు
are either absent or two in number	ఒకటి లేదా రెండు ఉంటాయి
he posted pictures of the same on twitter	ఆ విషయాన్ని ఆయనే స్వయంగా సహా ట్విట్టర్ లో పెట్టి
she acts in a variety of tv	ఆమె పలు నటించారు
we gave message of peace to the world	ప్రపంచానికి దేశం శాంతి సందేశాన్ని
the last date for application is november	దరఖాస్తు చివరి తేదీ నవంబర్ ఆసక్తి ద్వారా దరఖాస్తు చేసుకోవచ్చు
jehovah has his people in another way	యెహోవా తన ప్రజలను మరో రీతిలో కూడా
the are the worst affected by smoking	పొగాకు కారణంగా అత్యంత ఎక్కువగా
isro has taken another step forward into space	అంతరిక్ష ఇస్రో మరో అవుతోంది
he won the academy award for his performance	వీరి అకాడమీ బహుమతి లభించింది
the incident took place at west hyderabad	ఈ ఘటన జిల్లాలో చోటుచేసుకుంది
he is reportedly set to join the bjp	ఆయన బీజేపీలో ప్రచారం జరుగుతోంది
do regular exercises like stretching walking and	మొదలైన వ్యాయామాలు చేయాలి
no compromise would be done on quality part	నాణ్యత విషయంలో ఎక్కడ కూడా లేదన్నారు
mode of the examination computer based test	పరీక్ష విధానం ఆన్లైన్ కంప్యూటర్ టెస్ట్
for instance do you laugh at	మీరు బట్టలు ఇతరులను
trump to import on steel aluminium	ఇనుము అల్యూమినియం ట్రంప్ ప్రపంచ దేశాలు
and component conditions is very common in	మరియు భాగం పరిస్థితులు చాలా సాధారణం
many are still being treated at different hospitals	ఇప్పటికీ అనేక మంది చికిత్స పొందుతున్నారు
total cases reported yesterday active cases deaths recovered	రాష్ట్రంలో మొత్తం కేసులు యాక్టివ్ కేసులు మరణాలు కాగా సంఖ్య
it is provided free at all government hospitals	ఇది అన్ని ప్రభుత్వ ఆసుపత్రుల్లో అందుబాటులో ఉంటుంది
the incident took place in east godavari district	తూర్పుగోదావరి జిల్లాలో ఘటన జరిగింది
the winter season is to an end	సీజన్ ముగింపు వస్తోంది
as many as persons discharged and reported dead	వీరిలో చికిత్స అనంతరం మంది కాగా మొత్తంగా మంది మరణించారు
the incident took place in the district	నగర్ జిల్లాలో ఓ ఘటన చోటుచేసుకుంది
the same situation is in the whole country	రాష్ట్ర వ్యాప్తంగా ఇదే పరిస్థితి కనిపించింది
i am born and brought up in mumbai	కానీ నేను పుట్టి పెరిగాను
the bjp however remained silent on the matter	అయితే మౌనంగా ఉన్న బీజేపీ మాత్రం ఇప్పుడు ఆ విషయం
he has struck five fours and three sixes	ఐదు ఎదుర్కొని మూడు పరుగులు చేసి అయ్యాడు
the second half was a different story entirely	రెండవది అన్నమయ్య అసలు కథ ఏమిటనేది
i never expected such a thing to happen	అలాంటి పరిస్థితి అస్సలు ఊహించలేదు
special attention is being paid to childrens education	ముఖ్యంగా పిల్లలకు ప్రాధాన్యత
the bjp is in power in the state	అధికారం
take a look at ananya instagram pictures	అనన్య పాండే ఇన్స్టాగ్రామ్లో ఫొటోలపై మీరు కూడా ఓ
he was unwell since the past few days	ఆయన గత కొద్ది రోజులుగా ఉన్నారు
i pray for his good health modi tweeted	ఆయన మంచి ఉండాలని అంటూ మోదీ ట్వీట్ చేశారు
he demanded immediate dismissal of the state government	రాష్ట్ర ప్రభుత్వం వెంటనే ఆయన డిమాండ్ చేశారు
job creation up at lakh in march	లక్షల మందికి ఉద్యోగాలు ఈపీఎఫ్ఓ
kl rahul falls short of a century	కేఎల్ రాహుల్ సెంచరీ
jesus called satan the ruler of the world	యేసు ఈ అని పిలిచాడు
he expressed to their family members	వారి కుటుంబ సభ్యులకు తన ప్రగాఢ సానుభూతి తెలిపారు
the state of rice farmers is no different	వ్యవసాయ కూలీల పరిస్థితి కూడా ఇందుకు భిన్నంగా లేదు
theres a megapixel selfie camera on the front	మెగాపిక్సల్ ముందు
if it doesnt happen then it doesnt happen	ఒకవేళ అది జరగదు ఒకవేళ ఒకవేళ ఒకవేళ ఒకవేళ ఒకవేళ ఒకవేళ
the court sentenced him to seven years	కోర్టు ఏడు సంవత్సరాల జైలు శిక్ష విధించింది
if not treated immediately it can be	వెంటనే చికిత్స చేయకపోతే రావొచ్చు
republic day celebrations are taking place across the country	గణతంత్ర దినోత్సవ వేడుకలు జరుగుతున్న సంగతి తెలిసిందే
lok sabha speaker senior bjp leader	లోక్ సభ స్పీకర్ పదవికి భాజపా సీనియర్ నేత నామినేషన్ దాఖలు చేసారు
each has its own and distinct qualities	ప్రతి రకం ఒక తప్పనిసరి వేరు దాని స్వంత లక్షణాలు మరియు లక్షణాలను కలిగి ఉంది
the smartphone is powered by the f processor	ఏ ఈ స్మార్ట్ ఫోన్ పనిచేయనుంది
chennai super kings vs delhi capitals csk vs	ధోనీ రైనా భారీ స్కోరు చేసిన చెన్నై సూపర్ కింగ్స్
teaser which was released recently has garnered tremendous response	తాజాగా విడుదలైన టీజర్కు మంచి రెస్పాన్స్ వచ్చింది
the incident took place in karimnagar town of telangana	కరీంనగర్ జిల్లా మండలం ఈ ఘటన చోటుచేసుకుంది
succeeded his brother as the king	తన సోదరుడు తరువాత వచ్చాడు
all opposition parties are coming together to stop bjp	బిజెపికి వ్యతిరేకంగా ప్రతిపక్ష
it is ready to start building at chosen site	చిత్రాలను ఖాళీ స్థలాన్ని అనుకూల
the officials informed the matter to the district authorities	స్థానికులు అధికారులకు సమాచారం ఇచ్చారు
maharashtra has the highest amount of tax on petrol	అత్యధిక
the situation is more serious at the government hospitals	ప్రభుత్వ పరిస్థితి మరింత ఉంది
was able to return to the school building	ప్రాథమిక పాఠశాల భవనం ఏర్పాటు చేశారు
we are working on developing a national gas	జాతీయ గ్యాస్ ను ఏర్పాటు చేసుకోవడానికి కసరత్తు చేస్తున్నాం
the produces a peak power output of	ఈ ఇంజన్ గరిష్టంగా శక్తిని ఉత్పత్తి చేస్తుంది
bodies recovered at a house in delhi s	ఢిల్లీలో ఒకే ఇంట్లో మంది వెలుగు చూసిన విషయం తెలిసిందే
sugarcane and are the most important agricultural crops	ఇక్కడి ప్రధాన వాణిజ్య పంటలు
however the authorities are yet to take any steps	అయినప్పటికీ చర్యలు తీసుకునేందుకు అధికారులు
the government is working hard to meet its objective	ప్రభుత్వ లక్ష్యంగా
no electronic devices are allowed in the exam hall	ఎలాంటి ఎలక్ట్రానిక్ పరీక్ష
plant resources of africa	తీసిన
the worst incident took place in the guntur district	గుంటూరు జిల్లాలో దారుణ ఘటన
the results are scheduled to be announced on monday	సోమవారం ఫలితం
the entire to the	యొక్క తెర
election commission ec released the schedule on thursday	కేంద్ర ఎన్నికల సంఘం గురువారం ఎన్నికల షెడ్యూల్ విడుదల చేసింది
it is lakh more than last years target	గత ఏడాది కంటే దాదాపు లక్షల అదనంగా సాగు కావడం విశేషం
he urged the government to stop the people	ప్రజలకు ఇబ్బంది పెట్టే పనులను ప్రభుత్వం కోరారు
his family members immediately shifted him to osmania hospital	ఇది గమనించిన కుటుంబ సభ్యులు వెంటనే వచ్చి అతడిని ఉస్మానియా హాస్పిటల్లో చేర్పించారు
her father is a property dealer and a farmer	ఆమె తండ్రి ఒక రైతు మరియు స్టాక్
it is one among constituencies in the anantapur district	రాప్తాడు శాసనసభ నియోజకవర్గం అనంతపురం జిల్లాలోని ఒకటి
however the cause of the incident is not known	అయితే ఈ ప్రమాదం గల కారణాలు తెలియరాలేదు
he talked to jewish women he taught women	ఆయన మాట్లాడాడు
the students parents the school staff for negligence	పాఠశాల సిబ్బంది వల్లే తమ పిల్లలకు ఈ పరిస్థితి తల్లిదండ్రులు ఆరోపించారు
however the government has maintained an approach	అయినా ప్రభుత్వం వైఖరితో
his disciples found great serving under jesus authority	యేసు అధికారం క్రింద సేవ చేయడంలో ఆయన శిష్యులు గొప్ప పొందారు
the incident happened in krishna district in andhra pradesh	తాజాగా ఆంధ్రప్రదేశ్ రాష్ట్రంలోని కృష్ణా జిల్లాలో జరిగిన ఓ సంఘటన కూడా ఇలాంటి చెందుతుంది
im not good at bringing people to their feet	నేను వారి బంధువుల శోకము
then it to art performance and music	అప్పుడు థియేటర్ డ్యాన్స్ మరియు కలిపి ఉంటాయి
hnahthial town is the administrative headquarters of the district	పట్టణం జిల్లా పరిపాలనా ప్రధాన ఏర్పాటు చేయబడింది
im of being taken for a	నేను ఎ కోసం తీసుకున్న అనే లేదు
the victim was sent to a hospital for treatment	దీంతో ఆ విభాగంలోకి తరలించారు
houses collapsed under the impact of the explosion	పేలుడు చుట్టుపక్కల ఉన్న ఐదు ఇండ్లు ధ్వంసం అయ్యాయి
the incident had taken place at karwar in karnataka	ఈ ఘటన ఉత్తర కన్నడ జిల్లాలోని లో చోటుచేసుకుంది
the accident occurred when a truck hit the car	కారును ఈ ప్రమాదం జరిగింది
the tongue is put in the and	కృత్రిమ
telangana has reported coronavirus cases and deaths till date	తెలంగాణలో ఇప్పటి వరకు కరోనా వైరస్ మందికి మంది మృత్యువాత పడ్డారు
bahadur shah had already fled to tomb	షా అప్పటికే
lay off tata motors cuts up to jobs	టాటా మోటార్స్ మంది
mans hand gets between metro coach door dies	మెట్రో రైలు డోర్ మనిషి ప్రాణాలు
the bandh was supported by trs and congress parties	టీఆర్ఎస్ కు బీజేపీ కాంగ్రెస్ లు మద్దతు
the interested farmers would be given subsidy of rs	రైతులకు లబ్ధి
coronavirus statewide lockdown to remain in force till may	దేశవ్యాప్తంగా కరోనా వైరస్ వ్యాప్తి ఉండటానికి మే వరకు లాక్ డౌన్ జారీ చేశారు
both had gone to the hotel for a dinner	ఓ హోటల్ కు లంచ్ కోసం వీరిద్దరూ మీడియా పడ్డారు
black white blue orange you can take your pick	నలుపు తెలుపు నీలం ఎంచుకోవచ్చు
equity investments yield good returns over the long term	ఓరియెంటెడ్ మ్యూచువల్ ఫండ్లు మంచి అందిస్తాయి
it is shot simultaneously in tamil telugu and hindi	తెలుగు తమిళం హిందీ భాషల్లో ఏకకాలంలో విశేషం
worlds largest cricket stadium is coming up in ahmedabad	అతిపెద్ద క్రికెట్ స్టేడియం
the should only be used for drinking	తాగునీటి మాత్రమే డీశాలినేషన్ సముద్రం శుద్ధి చేసిన పరిశ్రమలకు స్పష్టం చేశారు
click on the image below for the video	కోసం కింద ఇచ్చిన క్లిక్ చేయండి
transmission options include a speed manual and automatic transmissions	స్పీడ్ మ్యాన్యువల్ మరియు ఆటోమేటిక్ ట్రాన్స్మిషన్ వీటిని ఎంచుకోవచ్చు
she is followed by priyanka chopra and deepika padukone	వారే పదుకొనే మరియు ప్రియాంక చోప్రా
the accused is a of the victim	నిందితుడు బంధువే కావడం గమనార్హం
water available places change according to the geographical conditions	నీరు ప్రదేశాలు భౌగోళిక పరిస్థితులను బట్టి మారుతుంది
women only own less than of the world property	ప్రపంచ మహిళలు శాతం కంటే తక్కువ సంఖ్యలో
but the apex court did not the appeal	తాము వేసిన పిటిషన్ను సుప్రీంకోర్టు వ్యాఖ్యానించారు
love is the most beautiful feeling in the world	ప్రేమ ప్రపంచంలోనే ఓ గొప్ప అనుభూతి
the main symptom of a respiratory is	దగ్గు అనేది యొక్క అత్యంత సాధారణ
the rear setup of the phone gets four cameras	ఫోన్ వెనక నాలుగు కెమెరాల సెటప్ ఉంది
but if not then its just not to be	కానీ ఈ సాధ్యం కాదు ఉంటే లేదు
but according to the tribal king of g	కానీ రాజు జి
greetings to telangana cm kcr garu on his birthday	కెసిఆర్ తెలంగాణకు చెప్పారు
tdp mps continue to raise modis speech	మోడీ టీడీపీ ఎంపీలు చర్చకు
has many historical as well as spiritual places	అనేక చారిత్రక ఆధ్యాత్మిక ప్రదేశాలు ఉన్నాయి
why are women so to personalities like these	కాబట్టి స్త్రీ స్వభావం గల పురుషుల పట్ల ఎందుకు
the condition of the farmers has only become worse	పైగా రైతుల పరిస్థితి అంతకుముందు కన్నా మారింది
below is an extensive photo click to view	దీనికి చెందిన మరిన్ని ఫోటోలను క్రింది మీద క్లిక్ చేయండి
rajini fans in chennai are in a festive mood	చెన్నైలో అభిమానుల ఆందోళన
amritsar three bsf soldiers injured in cross border firing	కాల్పులు ముగ్గురు గాయాలు
karnataka state complete lockdown every sunday till august	ఇక కోవిడ్ రోగుల సంవత్సరాలకు పెంచారు
sharma of the cpi won the seat in	లో సిపిఎం గెలిచిన రావు ఆ తరువాత
new delhi indian badminton stars saina nehwal and pv	న్యూఢిల్లీ చైనాలో జరుగుతున్న ఆసియా బ్యాడ్మింటన్ ఛాంపియన్షిప్లో భారత స్టార్ పి వి సింధు సైనా శుభారంభం చేశారు
on the front it has a megapixel selfie camera	మెగాపిక్సెల్ కెమెరా సెల్ఫీ ఆకట్టుకుంటుంది
these products can further be divided into two	ఈ ఉత్పత్తులు రెండు గ్రూపులుగా
president mukherjee congratulated isro for the successful test	విజయవంతం చేసిన ఇస్రో భారత రాష్ట్రపతి ప్రణబ్ ముఖర్జీ అభినందనలు తెలిపారు
tamil music director anirudh ravichander is the music	తమిళ సంగీత దర్శకుడు అనిరుధ్ సంగీతం అందించనున్నారు
postmortem report revealed injury marks on her body	హత్యకు గురైన పోస్టుమార్టం నిర్వహించగా ఆమె గాయాలు గుర్తించారు
the majority of these cases are in china	ఈ కేసులలో ఉన్నాయి
the body was later shifted to osmania hospital for postmortem	అనంతరం పోస్టుమార్టం నిమిత్తం ఉస్మానియా ఆసుపత్రికి తరలించారు
the clues team arrived at the scene and collected evidence	క్లూస్ టీమ్ సభ్యులు ఘటనా స్థలానికి చేరుకుని సేకరించారు
batsman who six and fours in his ball knock	వ నంబర్ ఆటగాడు శ్రీనాథ్ అరవింద్ బంతుల్లో ఒక సిక్స్ చేయడం విశేషం
the incident took place in the area of bengaluru	భగత్ ప్రాంతంలో ఈ ఘటన చోటు చేసుకుంది
ranveer singh played the role of in the movie	రణ్వీర్ సింగ్ నటించిన కనిపించారు
product page david r ed	ఆక్సైడ్
another person who suffered greatly was a man named steve	స్టీవ్ అనే అతను కూడా చాలా
the condition of both are critical according to the doctors	ఇద్దరి పరిస్థితి ఉన్నట్లు వైద్యులు తెలిపారు
the five persons the car died on the spot	కారులో ఉన్న ఐదుగురు వ్యక్తులు అక్కడికక్కడే మృతి
former australian cricketer passes away after suffering	ఆస్ట్రేలియా మాజీ క్రికెటర్ ఆకస్మిక మరణం
mr justice bhatt president presided over the function	ట్రిబ్యునల్ అధ్యక్షుడు జస్టిస్ శ్రీ భట్ సమావేశానికి అధ్యక్షత వహించారు
world book day is being organised by the since	ప్రపంచ పుస్తక
add in tomatoes coriander mint and curd and mix well	పచ్చిమిర్చి అల్లం ముక్కలు జీడిపప్పు మిక్సీలో వేసి మెత్తగా రుబ్బాలి
member name official website web portal of district	అధికారిక వెబ్సైట్
fire teams reached the spot immediately after receiving the information	సమాచారం అందుకున్న సహాయక బృందాలు వెంటనే రంగంలోకి దిగాయి
karnataka a meeting of congress leaders is underway in bengaluru	బెంగళూరు కర్నాటక బిజెపి నేతలు హోటల్లో సమావేశమయ్యారు
a large number of party workers locals attended the party	ఈ కార్యక్రమంలో పెద్ద ఎత్తున పార్టీ స్థానిక ప్రజలు పాల్గొన్నారు
it is still not clear how she the virus	దీంతో ఆమెకు వైరస్ ఎలా లేదు
several bollywood personalities expressed shock and grief over her death	ఆమె బాలీవుడ్ సినీ ప్రముఖులు దిగ్భ్రాంతి వ్యక్తం చేశారు
temple is a unique of the tourism	పర్యటనలో దేవాలయం చాలా
ap cm ys jagan to pay tributes at ysr ghat	ఘన నివాళులు ఏపీ సీఎం వైఎస్ జగన్
read sonia gandhi manmohan singh at to meet	చదవండి కలిసిన సోనియా మన్మోహన్
good news for the people looking out for government jobs	ప్రభుత్వ ఉద్యోగం కోసం నిరుద్యోగులకు గుడ్న్యూస్
a person was killed and another injured in the incident	ఈ ఘటనలో ఒకరు మృతి చెందగా మరొకరికి తీవ్ర గాయాలయ్యాయి
upendra and nayantara starred in the movie as lead actors	నయనతార మరియు నటించారు
about lakh people are expected to participate in the event	సుమారు లక్షల మంది ఆ కార్యక్రమానికి అంచనా
but the government did not accept either of these proposals	కానీ ఈ ప్రతిపాదనలను ప్రభుత్వం పట్టించుకోలేదు
however the interest paid is not under section c	ఉద్యోగుల జమ అయ్యే సెక్షన్ కింద పన్ను పడదు
it is his responsibility to the constitutional rights	సంస్థల బాధ్యత తనపై ఉందన్నారు
pm modi the dr ambedkar international centre in delhi	న్యూ ఢిల్లీలో ప్రధాని మోదీ డాక్టర్ అంబేద్కర్ ఇంటర్నేషనల్ సెంటర్ ను దృశ్యం
the magnitude of the earthquake was on the richter scale	భూకంప తీవ్రత రిక్టర్ పై గా నమోదైంది
the place has nearly of birds animals and	మరియు మొక్కల అరుదైన జంతువులు క్షీరదాలు వివిధ కలిగి ఉన్న ఒక భారీ రిజర్వ్ ఉంది
parents of the girl demanded stern action against the accused	కఠిన చర్యలు తీసుకోవాలని బాధితురాలి తల్లిదండ్రులు డిమాండ్ చేస్తున్నారు
assembly in shivaji park uddhav thackeray sworn in as cm	శివాజీ పార్క్లో ముఖ్యమంత్రిగా ఉద్ధవ్ ఠాక్రే ప్రమాణ స్వీకారం
the state government is no way involved in the incident	దీన్ని తెచ్చేందుకు ఇటు రాష్ట్ర ప్రభుత్వ యంత్రాంగం చొరవ లేదు
the accident caused a major traffic jam on the road	దాంతో రోడ్డుపై వాహనాల రద్దీ లేకపోవడంతో పెద్ద ప్రమాదం తప్పింది
the meeting would be attended by senior ministers and	మంత్రులు సీనియర్ అధికారులు ఈ భేటీలో
however he falls for her and to couple up	అయితే అతను ఆమెను
it employs about professionals and has over customers globally	కంపెనీకి ప్రపంచ వ్యాప్తంగా ఉండగా మంది ఉద్యోగులు పని చేస్తున్నారు
condolences to families of the victims who lost their lives	ప్రమాదంలో కుటుంబాలకు ప్రగాఢ సంతాపం
a number of mps and mlas participated in the meeting	ఈ కార్యక్రమంలో పలువురు ఎమ్మెల్యేలు శాసన సభ సిబ్బంది పాల్గొన్నారు
we are at the cusp of the fourth industrial revolution	నాలుగో పారిశ్రామిక మాత్రం చురుగ్గా
the indian team won the toss and elected to field	టాస్ గెలిచిన భారత్ జట్టు ఎంచుకుంది
many of the things we worry about never happen anyway	ఆయన ఇచ్చిన సలహా ఎంతో
most of them are selected for the and ifs	దీనిలో వారిని ఐఏఎస్ ఎంపిక చేస్తారు
i really enjoyed batting at number three in sri lanka	శ్రీలంకలో బ్యాటింగ్ చేయ బాగా
maruti suzuki discounts indias largest car manufacturer offers major discounts	మారుతి సుజుకి బంపర్ ఆఫర్ అదిరిపోయే డిస్కౌంట్
these include both doctors nurses and other health care staff	వీరిలో వైద్య చెందిన డాక్టర్లు తదితర సిబ్బంది కూడా ఉన్నారు
the mobile device market is growing at a huge speed	కోసం మార్కెట్ వేగంగా పెరుగుతోంది
elections are scheduled to be held on saturday	ఈనెల వ తేదిన శనివారం ఎన్నికలు జరగనున్నాయి
the gap between the hindus and the muslims was reduced	హిందువులు మధ్య దూరం పెరిగింది
the scooter gets two different modes sport and ride	స్కూటర్లో ఎకో స్పోర్ట్ అనే రెండు ఉంటాయి
in so doing we learn the limits of pure reason	ఈ శ్రద్ధ వలన మాత్రమే
later she was taken to government general hospital in guntur	ఆ తర్వాత చికిత్స ఖర్చు లేక గుంటూరు ప్రభుత్వ చేర్పించారు
in how many states are you present in the country	మనదేశంలో రాష్ట్రాలు ఉన్నాయి
a total of candidates had filed nominations for the bypoll	మరోవైపు ఉప ఎన్నికల్లో నామినేషన్ లో మొత్తం చేశారు
champions trophy pakistan team after victory over sri lanka	ట్రోఫీ ఆస్ట్రేలియా ఘన విజయం
so its never a good idea to think too much	కాబట్టి ఎప్పటికీ ఉండదు
of electricity occur when drought reduces water	కరువు నీటి క్రమానుగతంగా విద్యుత్తు దారితీస్తుంది
dinner it should be the meal of the day	డిన్నర్ రాత్రిపూట ఆహారం తీసుకోవాలి
so she starts loving rao and to marry	కాబట్టి పెళ్ళి
you can even add a little lemon juice to it	దీనికి కొంచెం నిమ్మరసం కూడా
the accident claimed lives and made several hundred people ill	ఈ ఘటనలో మంచి చనిపోగా వందల సంఖ్యలో బాధితులు అయ్యారు
the information is to be given in two days time	వీటిని రెండు రోజుల్లో పోలీసులకు సమాచారం
the net profit stood at rs crore as against rs	కోట్ల నికర లాభం
he has announced to face the case in the court	ఈ కేసును తాను న్యాయ స్థానంలో ప్రకటించాడు
the second season did get a bit heavy on me	సెకండ్ సీజన్ కాస్త మారింది
rrr stars jr ntr and ram charan in lead roles	ప్రధాన పాత్రల్లో రామ్ చరణ్ ఎన్టీఆర్
her uncle rajesh died on the spot in the accident	ఈ ప్రమాదంలో రాజేష్ అక్కడికక్కడే మృతి చెందారు
bus accident killed after bus falls into river	ప్రయాణికులతో ఉత్తర నుంచి వెళ్తున్న బస్సు నదిలో పడింది
it is sung by vishal and	ఇది మరియు విశాల్
firefighters are at the spot trying to douse the fire	సంఘటనా స్థలానికి చేరుకున్న అగ్నిమాపక సిబ్బంది మంటలను అదుపులోకి తెచ్చేందుకు ప్రయత్నిస్తున్నారు
he spoke to the officials and about the incident	వివరాలు అడిగి తెలుసుకున్నారు
he has taken five wickets in an innings three times	మూడు వికెట్లు ఐదు సార్లు తీశాడు
it all happened within a matter of a few seconds	ఇదంతా కొన్ని సెకన్ల లోపే కనిపిస్తుంది
he was my good friend at one point of time	అప్పట్లో ఆయన నాకు మంచి
pawan kalyan and trivikram srinivas are jointly producing the movie	కలిసి పవన్ ఈ చిత్రాన్ని నిర్మించడం విశేషం
these foods are usually high in fat salt and calories	ఫాస్ట్ ఫుడ్ లో మరియు కొవ్వు ఎక్కువగా ఉంటాయి
why did you choose for the lead role	ఈ సినిమాకు తరుణ్ ఎందుకు హీరోగా ఎంచుకున్నారు
marks superstar rajinikanth and director ar first	సూపర్స్టార్ రజనీకాంత్ స్టార్ దర్శకుడు కాంబినేషన్లో రూపొందుతున్న తొలి సినిమా
you can post these on whatsapp facebook twitter or instagram	వాట్సాప్ ఫేస్బుక్ ట్విట్టర్ ద్వారా వీటిని ఉపయోగించవచ్చు
he prayed to god to rest her soul in peace	ఆయన ఆత్మకు భగవంతుని తెలిపారు
his son of resisted the	అతని కుమారుడు గట్టిగా వ్యతిరేకించారు
the pictures of them together are on the internet	కలిసి ఉన్న వారిద్దరి ఫొటోలు ఇంటర్నెట్లో వైరల్గా మారాయి
who was driving the car is yet to be known	ఇంతకీ కారు తెలియని నెలకొంది
public is one excellent method of spreading the good news	బహిరంగ ద్వారా మంచి ఫలితాలు ఏమి చేయాలి
he wrote five novels five short story and a	ఈయన ఐదు నవలలు ఎనిమిది చిన్న కథలు తొమ్మిది నాన్ కి సంబంధించిన రచించారు
directed by vamshi maharshi stars mahesh babu and pooja hegde	వంశీ దర్శకత్వంలో రూపొందిన ఈ సినిమాలో మహేష్ సరసన అందాల భామ పూజా హెగ్డే
it is hard to imagine how adam or could sin	కూడిన నిత్య జీవితం ఉంది
sharma is seen playing the leading lady alongside ravi	సరసన శర్మ హీరోయిన్గా నటించారు
the meeting took place in the bjp head office in delhi	ఢిల్లీలోని బీజేపీ కేంద్ర కార్యాలయంలో ఈ కార్యక్రమం జరిగింది
the government is committed to the income of farmers by	నాటికి రైతుల రెట్టింపు చేయడమే సర్కారు లక్ష్యం
tamil rajinikanth has finally announced his entry into politics	తమిళ సూపర్ స్టార్ రజినీకాంత్ ఇటీవలే రాజకీయ చేశారు
best playback singer female mishra main secret superstar	ఉత్తమ మిశ్రా సూపర్స్టార్
in time several other members of the family did the same	అతను వెళ్లలేదు
dabangg starring salman khan and sonakshi sinha is directed by	సల్మాన్ ఖాన్ సిన్హా జంటగా దర్శకత్వంలో పై భారీ అంచనాలు ఉన్నాయి
for example a year old woman refused to be	ఉదాహరణకు ఒక స్త్రీ తనను అలా ఒప్పుకోలేదు
on the other hand employees continued their strike for consecutive days	ఇక అదే సమయంలో గత రోజులుగా కార్మికులు సమ్మె చేస్తున్నారు
for example some their lives by living beyond their means	నిజమే ఏదైనా ఉద్యోగం వరకు విద్య
inx media case cbi files charge against p chidambaram others	ఐఎన్ఎక్స్ మీడియా కేసులో ఆయన సహా మంది
however players walked off the field just as the rain arrived	అయితే ఒక్క బంతి కూడా వర్షపు జల్లు ఆటగాళ్లంతా
the situation is almost same in other parts of the city	దేశంలోని ఇతర దాదాపు ఇదే పరిస్థితి
the sons of and according to their families	కుమారులు వారి వారి చొప్పున
i pledge to keep secret whatever may happen to me	ప్రమాదవశాత్తు ఏదన్నా ప్రమాదం వీరి గురించి వారు
ovarian syndrome is a in women	వైద్యుడు సిండ్రోమ్ ఒక స్త్రీ జననేంద్రియ అని
credit for gst rate cuts goes to rahul gandhi says congress	జీఎస్టీ తగ్గింపు క్రెడిట్ కాంగ్రెస్ రాహుల్ గాంధీ
mumbai indian captain virat kohli is breaking sachin tendulkars every record	హైదరాబాద్ క్రికెట్లో ఉన్న అన్ని రికార్డులను విరాట్ కోహ్లీ కొడుతూ
their father works as a labourer and mother is a	తండ్రి తల్లి గా పనిచేస్తున్నారు
power supply in several areas was disrupted to the rains	విద్యుత్ సరఫరా పలు ప్రాంతాలు
he reportedly went to office on monday and did not return	కార్యాలయానికి వెళ్లి బాధ్యతలు ప్రకటించారు
mg electric suv deliveries begin first vehicle delivered to	అందులో భాగంగానే తొలి ఎలక్ట్రిక్ ఎలక్ట్రిక్ కారును పూర్తి స్థాయిలో మార్కెట్లోకి తీసుకొచ్చారు
we must ask then is the bible just another religious book	బైబిలు కేవలం పుస్తకం
a month later i started to serve as a traveling overseer	ఒక నెల తర్వాత నేను ప్రయాణ సేవ చేయడం
if true in the run application is made available	నడుపుము నందు అందుబాటు లో ఉంచు
superstar mahesh babu is one of the biggest stars in tollywood	టాలీవుడ్ సినిమా ఇండస్ట్రీ లో సూపర్ స్టార్ మహేష్ బాబు బ్లాక్ సంగతి తెలిసిందే
the incident took place at ntr nagar in district	ఈ సంఘటన జిల్లా మండలం చోటు చేసుకుంది
lets take a closer look at some of these key issues	వీటిలో కొన్ని ముఖ్యమైన కేసులను ఒకసారి
in previous elections the jdu and bjp used to fight together	గత ఎన్నికల్లో ఇక్కడ టీడీపీ బీజేపీ జనసేన కలిసి కూటమిగా పోటీకి దిగాయి
it the hair leaving it looking soft and healthy	ఇది సాంద్రత మరియు ఆరోగ్యకరమైన జుట్టు ఇస్తుంది
the injured child was handed over to the child welfare committee	బాధితురాలిని చైల్డ్ అప్పగించారు
it boosts your energy to keep you active throughout the day	రోజంతా చురుకుగా సామర్థ్యాన్ని పెంచుతుంది
despite its growing market share was already financial problems	స్థిరమైన అభివృద్ధి ఉన్నప్పటికీ యొక్క అభివృద్ధి సమస్యల వల్ల
it is situated in balochistan province about km north of	ఇది రాష్ట్రంలో నుండి కి
the modi government is pushing the of of education	మోడీ ప్రభుత్వం విద్యను
was murdered on october in the saudi consulate in	సౌదీ అరేబియా దౌత్య కార్యాలయంలో అక్టోబర్ న హత్యకు గురైన సంగతి తెలిసిందే
google is planning to the design of for web	కు కొత్త వెబ్ డిజైన్ ను పనిలో ఉంది గూగుల్ సంస్థ
r madhavan and anushka is directed by madhukar	అనుష్క మాధవన్ దర్శకుడు హేమంత్ మధుకర్ తెరకెక్కించిన చిత్రం
the mg is available in both petrol and diesel engines	పెట్రోల్ మరియు డీజల్ ఇంజన్
our business and industry play an important role in	బ్రిక్స్ దేశాల మన పారిశ్రామిక రంగం ప్రముఖ పాత్ర పోషిస్తాయి
he accused the government of misleading the people on the issue	ప్రభుత్వంపై ప్రజల్లో చేస్తున్నారని ఆరోపించారు
likewise without of spiritual food we and die	అదేవిధంగా ఆధ్యాత్మిక ఆహారం మనం బలహీనపడి ఆధ్యాత్మికంగా
in telangana too the bjp lost four of its five seats	తెలంగాణ ఎన్నికల్లో ఐదు సీట్ల నుంచి నాలుగు బీజేపీ ఎద్దేవా చేశారు
shopping grab discount of up to to on car	ఇండియా టైమ్స్ షాపింగ్ మీద శాతం వరకు డిస్కౌంట్లను అందించింది
the deceased is survived by wife two sons and a daughter	మృతుడికి ఇద్దరు కుమారులు కూతురు భార్య ఉన్నారు
instagram music has three showing popular songs and	ఇన్స్టాగ్రామ్ లో వచ్చే ఈ మ్యూజిక్ లో పాపులర్ సాంగ్స్ అలాగే ఇలా మూడు సదుపాయాలు ఉంటాయి
these visible however are the result of hpv types	అయినప్పటికీ ఈ కనిపించే వృద్ధులు క్యాన్సర్ కాని ఫలితం
the wicked one does not benefit even if he gains	యోబు వాటి నుండి ప్రయోజనం
he is the uncle of ysrcp chief ys jagan mohan reddy	ఆయన వైఎస్సార్ సీపీ పార్టీ అధినేత జగన్ మోహన్ రెడ్డి
the accident was one of the worst in pakistans history	పాకిస్థాన్ విమానయాన చరిత్రలోనే ఘోర ప్రమాదం జరిగింది
movie director harish shankar for to the visitors	దర్శకుడు హరీష్ శంకర్ మాట్లాడుతూ ప్రేక్షకులకు ధన్యవాదాలు తెలిపాడు
amazon founder jeff bezos and his wife are getting	అమెజాన్ వ్యవస్థాపకుడు జెఫ్ బెజోస్ ఆయన భార్య వివాహం జీవితం ఇక ముగిసిన అధ్యాయం
massive fire broke out at a scrap shop in	విశాఖపట్నం నగరంలోని భారీ అగ్ని ప్రమాదం
the examination report should be done within hours of the journey	ఈ మేరకు ప్రయాణం ముగిసిన పరీక్ష నివేదికను
the cases in the country continue to rise day by day	రోజు దేశంలో కేసులు పెరిగిపోతున్నాయి
bollywood actor nana says farmers could become heres why	రైతులు నానా
he plays for sunrisers hyderabad in the indian premier league ipl	ఢిల్లీ ఇండియన్ ప్రీమియర్ లీగ్ ఐపీఎల్లో సన్రైజర్స్ హైదరాబాద్కు తన
theres a few things i while doing these day challenges	ఈ రోజులు నేను కొన్ని విషయాలను
chhattisgarh in chhattisgarh corona community survey campaign is going on	ఛత్తీస్గఢ్ రాష్ట్రంలో కరోనా సర్వే కార్యక్రమం కొనసాగుతోంది
is a village located close to the temple	టెంపుల్ కి దగ్గరలోని గ్రామం ఈ
set to true to disable showing known users in the window	తెలిసిన
thoughts about the tata tiago variant to new feature updates	టాటా టియాగో కొత్త డ్రైవ్స్పార్క్ అభిప్రాయం
gujarat punjab and himachal pradesh stood at fourth fifth and sixth spots	గుజరాత్ ఆంధ్రప్రదేశ్ రాజస్థాన్ మూడు నాలుగు ఐదు స్థానాలు పొందాయి
the three ministers are and	ఆ మంత్రి నాని వంశీ
are going to score the music and is the cinematographer	ఈ మూవీ కి శంకర్ సంగీతం సినిమా ఫోటో గా వర్క్
the song is written by and sung by simha priya	ఇక రామ సీత పాటను రాయగా ప్రియా పాడారు
honda has unveiled its new rebel motorcycle for the global markets	జపాన్ కేంద్రంగా పనిచేస్తున్న ద్విచక్ర వాహనాల తయారీ సంస్థ హోండా మోటార్సైకిల్ తన కొత్త బైక్ను ఆవిష్కరించింది
hyderabad an appalling incident happened in the pedapalli district situated in hyderabad	హైదరాబాద్ నగరంలోని ప్రాంతంలో దారుణం చోటు చేసుకుంది
the day started out warm but at the temperature dropped rapidly	సునామీ చాలా ఉన్నది కానీ అది త్వరగా తగ్గిపోయింది
not just a poet par he is an excellent singer too	ఒక కాకుండా కూడా చాలా గొప్ప వ్యక్తి
rather than us he gives us loving direction for our good	ఆయనకు బాగా తెలుసు
the is expected to be launched at the delhi auto expo	వీటిని అతి త్వరలో ఢిల్లీ ఆటో ఎక్స్పోలో
it is high in fibre vitamin b potassium and essential	వీటిలో ప్రొటీన్ అధిక పోషకాలు కలిగి ఉంటాయి
rest of the drama is how wins the heart of	కృష్ణుడు ఎలా మిగిలిన కథ
she suffered per cent burns and died during treatment at a hospital	దాదాపు శాతం కాలిన గాయాలతో ఆసుపత్రిలో మధ్య మరణించాడు
it is for bjp to include such a party and individual	అలాంటి పార్టీని బీజేపీ
it has built the worlds highest bridge at over river	ఈ వంతెన నది మట్టానికి మీటర్ల ఎత్తులో ఉంటుంది
she was when she was rushed to a nearby hospital	తీవ్ర కావడంతో తర్వాత ఆస్పత్రిలో
well was it in the interest of the nation or your clients	నిజానికి ఇది లేక మీ ప్రయోజనాల మొత్తం మీద మీరు
maharashtra assembly to next week new mlas to be sworn in	ఇక బుధవారం మహారాష్ట్ర ఎమ్మెల్యేలు ప్రమాణస్వీకారం చేస్తారు
while the series costs between rs lakh and rs lakh	లక్షల మధ్య రిటైల్ సిరీస్ ధర రూ
he was awarded indias highest award the bharat in march	లో భారత ప్రభుత్వం అత్యంత భారత పురస్కారం అందించింది
therefore a healthy lifestyle is a must for a healthy immune system	ఇలా వ్యవస్థ అవసరం ఎంతైనా ఉంది
in a time of emergency one can not live a normal life	మరి
i mean these things are just coming out of the walls	దీనికి పూర్వము అని ఆ గ్రామ మీద
the movie is a drama based on the life of jayalalithaa	అమ్మ జయలలిత జీవితం ఆధారంగా సినిమాను తెరకెక్కిస్తున్నారు
assistance of voluntary organisations and citizens should be sought for the arrangements	స్వచ్ఛంద సంస్థలు పౌర సహాయ తీసుకోవాలి
following is the text of prime ministers message on national day	జాతీయ చేనేత లో ప్రధాన మంత్రి ఇచ్చిన సందేశం యొక్క పాఠం ఈ దిగువ గా ఉంది
the leaders of the two parties are taking jibes at each other	ఇరు పార్టీల నేతలు ఒకరిపై ఒకరు విమర్శలు
the wages of labourers should be hiked according to the price hike	పెరుగుతున్న ధరలకు అనుగుణంగా కార్మికుల వేతనాలు
she has reportedly featured in over telugu tamil and hindi movies since	తెలుగు తమిళ భాషలలో కలిపి సుమారు కి పైగా చిత్రాల్లో నటించింది
he was seen by some perhaps when he go make disciples	బహుశా ఆయన మందికి మీరు వెళ్లి
new delhi warning bells are for the national capital once again	న్యూఢిల్లీ దేశ రాజధాని మరోసారి
trade target of us billion trade by anand sharma	నాటికి భారత్ ఫ్రాన్సు మధ్య బిలియన్ వ్యాపార లక్ష్యం ఏర్పాటు చెప్పారు
travellers are recommended to visit bridge on their trip to	పర్యాటకులు కూడా తప్పక చూడాలి
literally the most word in the language has officially changed	భాషలో అత్యధిక పదం అధికారికంగా నిర్వచనం మార్చబడింది
chandrababu has duped the farmers in the name of crop loan waiver	రుణమాఫీ పేరుతో రైతులను చంద్రబాబు
he has fastest century by an indian cricketer in odis in balls	రికార్డ్ సెంచరీ సాధించిన చెందిన ప్లేయర్
the countrys capital houses the most diverse selection of cultural activities	దేశ రాజధాని సాంస్కృతిక విభిన్న ఎంపిక
however the sources did not the name of the american	అయితే ఆ పేరును మాత్రం వెల్లడించలేదు
the and the are two major rivers in the south	ఇతర దక్షిణాన ప్రాధాన్యత ఉన్నాయి
weve made the decision to stop all political advertising on twitter globally	ప్రపంచవ్యాప్తంగా ట్విట్టర్లో అన్ని రాజకీయ నిర్ణయం
rrr movie is being produced by dvv danayya under dvv entertainments banner	వర్కింగ్ షూటింగ్ ఈ చిత్రాన్ని బ్యానర్పై దానయ్య నిర్మిస్తున్నారు
the unity and the integrity of the country are the	దేశ సార్వభౌమాధికారం అత్యంత
hyderabad ysr congress party ysrcp is gearing up for the upcoming elections	రానున్న ఎన్నికల కోసం వైఎస్సార్ కాంగ్రెస్ పార్టీ
hyderabad trs congress and bjp are gearing up for the huzurnagar byelections	హుజూర్ నగర్ ఉప ఎన్నికలను అధికార ఎస్ కాంగ్రెస్ బీజేపీలు
net interest income is the difference between interest earned and interest	సంపాదించిన వడ్డీ చెల్లించిన మధ్య నికర వడ్డీ ఆదాయం అంటారు
accordingly the japan became the second biggest economic system in the world	ప్రకారం జపాన్ ప్రపంచంలో రెండవ పెద్ద ఆర్ధిక వ్యవస్థ
trs in telangana has slipped quite badly in the lok sabha elections	ఈ ఎన్నికల్లో ఎస్ ఘోరంగా ఓడిపోయింది
dev was of buddhist origin but later started following practices	బౌద్ధ చెందినవాడు కాని తరువాత
the maharashtra agricultural lands on amendment act maharashtra act of	మహారాష్ట్ర వ్యవసాయ సవరణ చట్టము లోని వ మహారాష్ట్ర చట్టము
the first was developed at and has undergone various	ఈ మొదటి నమూనాను వాయుసేన మూడో తయారు చేశారు
he asked the states to and send suggestions for the exit strategy	ఈ సంబంధించి రాష్ట్రాలు ఆలోచన చేయాలని ప్రధానమంత్రి సూచించారు
the of pakistan afghanistan and bangladesh provide for a specific state religion	పాకిస్తాన్ ఒక నిర్దిష్ట రాజ్య ప్రకటించాయి
when i came to know jehovah i was helped to quit those	నేను యెహోవాను ఆ నాకు సహాయం లభించింది
currently allu arjun is acting in a movie under the direction of sukumar	ఇక అల్లు అర్జున్ సుకుమార్ తెరకెక్కిస్తున్న సినిమాలో నటిస్తున్నాడు
is the camera while vishal chandrasekhar is the music	విశాల్ చంద్రశేఖర్ ఈ సినిమాకు సంగీత వంశీ పచ్చి సినిమాటోగ్రఫీ చేస్తున్నారు
gadkari is pitted against former mp and congress leader nana in nagpur	బీజేపీ మాజీ ఎంపీ కాంగ్రెస్ అభ్యర్థి నానా గడ్కరీ
the movie is directed by rajamouli and produced by danayya under dvv entertainments	రాజమౌళి దర్శకత్వంలో రూపొందుతున్న ఈ మూవీని బ్యానర్పై దానయ్య నిర్మిస్తున్నారు
students are advised to work hard to get good results in the studies	విద్యార్థులకు ఉత్తమ ఫలితాలు రావడానికి కృషి చేయాలని అన్నారు
prakash raj sangeetha rajendra prasad rao ramesh are seen in key roles	రావు రమేశ్ కీలక పాత్రలు పోషిస్తున్నారు
the four youths took the girl to a area and raped her	బాలికను ఐదుగురు ఆమెను ప్రాంతానికి సామూహిక పాల్పడ్డారు
as the guest to the g conference held in	జరిగిన ఉన్న
tdp mp cm ramesh is on a hunger strike for kadapa steel factory	కడప ఉక్కు వరకూ పోరాటం తాజాగా టీడీపీ ఎంపీ సీఎం రమేష్ దీక్ష చేశారు
the future of my government is not in the hands of the opposition	నా ప్రభుత్వం యొక్క భవిష్యత్తు ప్రతిపక్షాల చేతిలో లేదు
after statements on rafale deal rahul accuses modi of soldiers blood	కోసం ప్రాణాలు రక్తాన్ని మోడీ రాహుల్
madhav was immediately taken to the cbi headquarters for after the arrest	అరెస్ట్ చేసిన వెంటనే మాధవ్ ను సీబీఐ తరలించారు
bollywood actress dutta recently accused veteran actor nana of sexual harassment	బాలీవుడ్ నటి ఇటీవల నటుడు నానా పై లైంగిక వేధింపుల ఆరోపణలు చేయడంతో మరోసారి తెరపైకి వచ్చింది
heat up some oil in a pan and stir fry the chicken pieces	ఒక వేయించడానికి పాన్ లో వెన్న వేడి మరియు కొద్దిగా వేయించాలి చికెన్ ముక్కలు
union rs cr as ii of covid financial package to statesuts	రాష్ట్రాలు కేంద్ర ప్రాంతాలకు కోవిడ్ ఆర్ధిక ప్యాకేజీ రెండవ వాయిదా కోట్ల రూపాయల మేర నిధులు విడుదల చేసిన కేంద్ర ప్రభుత్వం
the match between kolkata riders and sunrisers hyderabad was a one	కోల్కతా సన్రైజర్స్ హైదరాబాద్ మధ్య జరిగిన మద్యం తాగి వచ్చారు
he was rushed to a nearby hospital where he was declared brought dead	అనంతరం ఉన్న ఆసుపత్రికి తరలించారు
asia badminton championships saina nehwal went down in semifinals in	హైదరాబాద్ ఆసియా బ్యాడ్మింటన్ చాంపియన్షిప్ సైనా నెహ్వాల్ ప్రణయ్
says people in the field are friendly and curious many are interested	చాలామంది ఆసక్తి
ever since the fans of the movie are eagerly waiting for kgf updates	గా ఈ సినిమా అప్డేట్స్ కోసం అన్ని భాషల సినిమా అభిమానులు చాలా ఆసక్తిగా ఎదురుచూస్తున్నారు
the viral infections are rising in ghmc limits and areas of hyderabad	జీహెచ్ఎంసీ కరోనా వైరస్
business educational and financial institutions remained closed in wake of the bandh	బంద్ నేపథ్యంలో వ్యాపార వాణిజ్య విద్యా సంస్థలను మూసివేశారు
the subjects english maths and telugu subjects are taught in the english	తెలుగు ఆంగ్లం ఉర్దూ మాధ్యమాల్లో బోధన జరుగుతుంది
the two joined the bjp at the residence of party president amit shah	బీజేపీ జాతీయాధ్యక్షుడు అమిత్ షా ఇద్దరూ పార్టీలో చేరారు
after his death his son karan took over the reins of productions	ఆయన కుమారుడు కరణ్ ప్రొడక్షన్స్ ను
ap cm chandrababu naidu has laid the foundation stone for airport	సిఎం ఈరోజు కుప్పం చేశారు
and acted as the female leads in the movie	ఈ చిత్రంలో అగర్వాల్ నటిస్తున్నారు
for australia bagged four wickets while nathan lyon took two wickets	ఆస్ట్రేలియా బౌలర్లలో నాథన్ లియోన్ మూడు వికెట్లు కైవసం చేసుకోగా జోష్ రెండు వికెట్లు పీటర్ సిడిల్ ఒక వికెట్ చొప్పున సాధించారు
he is survived by his wife two sons and two daughters	ఆయనకు భార్య ఇద్దరు కుమారులు ఇద్దరు కుమార్తెలు ఉన్నారు
many people do and who today is not affected by crime and violence	చాలామంది అలాంటి ఉన్నారు
the imagination is topped by the hindu holy of vishnu and	బ్రహ్మ విష్ణు చేస్తాయి
the final straw was the governments appointment of s to the rbi board	ఆర్బీఐ ఎస్ ఇటీవల ప్రభుత్వం నియమించింది
thus yoga has plenty of to open the of employment world over	ప్రపంచవ్యాప్తంగా రానున్నాయి
on the third day of navratri the form of goddess durga is worshipped	నవరాత్రి మూడోరోజు ఆకారంలో ఉన్న ధరించి ఉంటుంది ఎంతో పరమార్థం పలు కనిపించే ఈ తల్లి మాత్రం ఎంతో అమ్మ చేత చక్కని పేరు పరాజయం భయం
a total of motors are being set up in pump houses under kaleshwaram project	కాళేశ్వరం ప్రాజెక్టు మొత్తంలో స్టేషన్లు పంపులు పనిచేస్తాయి
if you dont get the ball over the goal line it doesnt mean enough	గోల్ అది అర్థం అని వ్యాఖ్యానించారు
jehovah became the person to me and he is still my friend	యెహోవా నాకు అత్యంత వ్యక్తి అయ్యాడు అత్యంత అని అంటున్నాడు
vijay deverakonda became a big name actor after his massive success in arjun reddy	అర్జున్ రెడ్డి చిత్రాల సూపర్ సక్సెస్ తరువాత విజయ్ దేవరకొండ హీరోగా మారిపోయాడు
is a village in guntur district of the indian state of andhra pradesh	గుంటూరు జిల్లా మండలానికి చెందిన గ్రామం
ranveer singh and deepika padukone are among the most loved celebrity couples in bollywood	ఎట్టకేలకు బాలీవుడ్ స్టార్ దీపికా పదుకొనె రణ్వీర్ సింగ్ తమ ప్రేమకు పెళ్లితో ఒక్కటి
the bjp people are spreading in the name of religion caste and region	మతం ప్రాంతం పేరిట బీజేపీ పెట్టడం దారుణమన్నారు
the turmeric and honey face mask helps to dark spots and acne	బాదం మిశ్రమం ముఖంలో మచ్చలను తగ్గించి ముఖానికి కాంతిని అందిస్తుంది
the number of dogs had increased in rural as well as urban areas	ఇక కుక్కల సంఖ్య పెరగడంతో అవి
the organisation includes more than scientists and about other scientific technical and supporting personnel	మొత్తం ఆర్ ఓ పైగా మంది సహాయక సిబ్బంది ఉన్నారు
the number of recovered cases among covid patients has risen to as of today	దేశంలో కోవిడ్ నుంచి ఇప్పటిదాకా సంఖ్య కు పెరిగింది
it is not for only manufacturing for the domestic market or import substitution	దేశీయ మార్కెట్ కు అవసరం అయిన ఉత్పత్తులు కూడా దీన్ని మా
nda nominee narayan singh was elected the deputy chairperson of the rajya sabha	ఆయన ఎన్డీఏ ఉమ్మడి అభ్యర్థి నారాయణ్ సింగ్ డిప్యూటీ ప్రకటించారు
continues because my parents are witnesses we discuss the daily text every morning	ఇంకా ఇలా నా తల్లిదండ్రులు కాబట్టి మేము ఉదయం
all is set for the zptc and mptc elections in the state on april	ఏప్రిల్ న జరిగిన ఎంపీటీసీ జెడ్పీటీసీ ఎన్నికల్లో అనుకూలంగా పనిచేయాలని ఒత్తిడి వచ్చింది
a few days ago i was giving around the valley in california	కొన్ని వారాల క్రితం అమెరికాలోని ఉండే ఏరియాలోని పలు ప్రాంతాల్లో నేను
of the family of the of the family of the	వంశస్థులు వంశస్థులు
stroke or brain attack is the third largest after cancer and heart disease	గుండె తర్వాత ప్రాణాలను మూడో అతి పెద్ద సమస్య
but since she could not change her situation she decided to change her	తాను తన పరిస్థితిని కనుక తన నిర్ణయించుకుంది
has samsung to take the lead in the indian premium smartphone market	ఇండియన్ స్మార్ట్ఫోన్ మార్కెట్లో ప్రీమియం విభాగంలో తనను నుంచి కంపెనీకి శాంసంగ్ అదిరిపోయే ఇచ్చింది
percent of the population speaks the of as their mother tongue	ప్రజలకు చెందిన ఉంది
produced by ram charan the surender reddy directorial has nayanathara as the leading lady	సురేందర్ రెడ్డి దర్శకత్వంలో రామ్ చరణ్ నిర్మిస్తున్న ఈ సినిమాలో నయనతార హీరోయిన్
yes the law acted as a temporary or leading to christ	అవును నడిపించే లేదా పనిచేసింది గల
home dont miss ed files fresh money laundering case against airways naresh goyal	జాతీయం వ్యవస్థాపకుడు నరేష్ గోయల్ పై ఈడీ కేసు నమోదు
american writer mark called the the most delicious fruit known to men	ప్రముఖ అమెరికన్ రచయిత మార్క్ అత్యంత అని
main are fuels vehicles and parts grain and other foods	జార్జియా ప్రధాన వాహనాలు యంత్రాలు భాగాలు ధాన్యం ఇతర ఆహారాలు ఔషధాలు ఉన్నాయి
a garden further adds to the beauty of the place and attracts the tourists	ఈ టెంపుల్ అందాలు కాక సైతం మరల మరల చేస్తాయి
she holds a in the right side and a lotus in the left	ఈమె కుడి చేతిలో కమలం ధరించి ఉంటుంది
the workers demanded the state government to send them back to their native places	తమను పంపాలని వలస ప్రభుత్వాన్ని
through the valleys the rivers down over of or	మధ్యలో ఉన్న మీదుగా సాగుతున్నాయి
ranji trophy named delhi captain nitish rana deputy for first two games	రంజీ ట్రోఫీ ఢిల్లీ జట్టు కెప్టెన్గా నితీష్ రాణా
the details of total loans and disbursed by public private sector banks are	ప్రభుత్వ ప్రైవేటు రంగ బ్యాంకులు మంజూరు చేసిన మొత్తం రుణాల వివరాలు
aamir khan plays the role of ali the main character of the novel	ఈ మూవీలో హీరో ఆమిర్ ఖాన్ కాగా బిగ్ ఓ కీలక పాత్ర
modi met a number of and during his stay in the	అనేక మంది మోడీ
ravi prakash went to high court and then to supreme court seeking anticipatory bail	గతంలో తనకు ముందస్తు బెయిల్ మంజూరు చేయాలని హైకోర్టును ఫలితం లేకపోవడంతో ఆ తర్వాత సుప్రీంకోర్టును ఆశ్రయించారు
new delhi former indian cricket team captain kapil dev has suffered a heart attack	ఢిల్లీ భారత జట్టు భారత మాజీ కెప్టెన్ కపిల్ దేవ్ తీవ్ర అసంతృప్తి వ్యక్తం చేశారు
former chief ministers farooq abdullah omar abdullah and mehbooba mufti are still under detention	ఇప్పటికే అక్కడ మాజీ ఫరూక్ అబ్దుల్లా ఒమర్ అబ్దుల్లా మెహబూబ గృహ ఉంచిన సంగతి తెలిసిందే
mystery of the death of members of a family in delhis remains	దేశ రాజధాని ఢిల్లీలోని ప్రాంతంలో జరిగిన మంది కుటుంబ సభ్యుల సామూహిక మరణాల ఉదంతం మారుతోంది
the brand is expected to add more cities to the service location list	ఈ బ్రాండ్ సర్వీస్ మరిన్ని నగరాలను సమాచారం
in the movie mahesh babu the role of an army major ajay krishna	కాగా ఈ సినిమాలో మహేష్ బాబు మొదటి సారి ఆర్మీ ఆఫీసర్ పాత్రలో మేజర్ అజయ్
power capital goods it banking and financial look positive whereas looks negative	బ్యాంకింగ్ ఐటీ టెక్నాలజీ హెల్త్ కేర్ ఉండగా ఆటో ఎఫ్ఎంసీజీ రంగాల్లోని షేర్లు ఉన్నాయి
he was a student leader and was elected as president of delhi university students union	ఢిల్లీ వర్సిటీలో భారతీయ విద్యార్థి పరిషత్ నేతగా
the engine comes paired to a speed gearbox and features the is technology	బిఎస్ కాలుష్య ఇందులో స్పీడ్ మ్యాన్యువల్ ట్రాన్స్మిషన్ గల అనుసంధానం చేశారు
the rear and the number plate appear to hang just above the rear wheel	ఉండే మరియు నెంబర్ పాత వేరియంట్ కన్నా పైభాగంలో ఉండేలా అమర్చారు
take an a size of paper and fold it to make a square	పరిమాణం యొక్క ఒక సాధారణ తద్వారా ఒక అవుతుంది ఒక రెట్లు
sold shares in anil ambani s companies after the value of collateral plummeted	విలువ అనిల్ అంబానీ కంపెనీల షేర్లను వాళ్లు ఇటీవల మార్కెట్లో
no shots are fired no bombs are dropped but war strategy is no less intense	లేవు వర్షాలు లేవు అంత కాదు
a team led by dsp singh the city to avoid any incident	దీంతో ఎలాంటి ఘటనలు జిల్లా సింధు శర్మ ఆధ్వర్యంలో పోలీసులు నిర్వహించారు
at the canada open super tournament and verma progressed to the	వేదికగా జరుగుతున్న కెనడా ఓపెన్ సూపర్ బ్యాడ్మింటన్ టోర్నీలో గేమ్ ఛాంపియన్
values start teaching your child at an early age about honesty integrity and respect	మీ గురించి స్పష్టంగా ఖచ్చితంగా చెప్పండి
by the fourth century began cutting into smaller pieces greater	వివిధ రంగులు చేయడమే గాక కావలసిన సులభంగా
praise is the man who yahweh who greatly in his	యెహోవాను ఆయన
the new v is powered by a cc engine	కొత్త వి సిసి సూపర్ కలిగి ఉంటుంది
her negative role in and was highly praised by and	ఆమె పాత్రను ప్రేక్షకులు ప్రశంసించారు
maruti suzuki has announced a price hike on its entire lineup in the indian market	మార్కెట్ లీడర్గా మారుతి సుజుకి ఇప్పటికే ధరల పెంపును ప్రకటించిన సంగతి తెలిసినదే
has approximately identified species animal species plant species and bacterial species and other	సుమారుగా జంతు జాతులు వృక్ష జాతులు జాతులు ఉన్నాయి
the literature was completed when the first novel written by was completed	మొట్టమొదటి కందుకూరి రచన తో తెలుగు పునరుద్ధరణ
pray to be as and as active in jehovahs service as you can be	యెహోవా వీలైనంత ఉత్సాహంగా చేసేలా సహాయం చేయమని ప్రార్థన చేయండి
rashmika mandanna the super gorgeous heroine has become the most sought after actress in tollywood	టాలీవుడ్ లో స్టార్ హీరోయిన్ గా రష్మిక మందన
rupee and a in international gold prices triggered surge in domestic gold price	రూపాయి క్షీణత ధర పెరగడంతో దేశీయ మార్కెట్లో బంగారం ధర అమాంతం దూసుకెళ్లింది
she made the remarks in the lok sabha during a debate on the union budget	కేంద్ర బడ్జెట్ పై లోక్ సభలో జరిగిన చర్చలో కవిత మాట్లాడారు
music is given by devi sri prasad and the cinematography is done by r	ప్రసాద్ సంగీతం అందిస్తున్నారు
indian cricket team recently defeated bangladesh in a historic test at the gardens	వేదికగా భారత్ బంగ్లాదేశ్ మధ్య జరుగుతున్న చారిత్రక టెస్టులో గట్టి షాక్ తగిలింది
it is taking shape on the banks of the river near gujarats capital	నదికి పశ్చిమ ఒడ్డున ఉన్న గుజరాత్ కి కొత్త రాజధాని
but we take bath once in the morning wash our face only the next day	కానీ మేము మాత్రం ఉదయం ముఖం స్నానం చేస్తాం
washington the presidential elections in the united states of america are underway in full swing	వాషింగ్టన్ అమెరికాలో అధ్యక్ష ఎన్నికల పోలింగ్ కొనసాగుతోంది
whether firefox results to protect you against addons to on	బ్లాక్ జాబితా ఫలితాలు లేదో పొడగింతలు వ్యతిరేకంగా మీరు రక్షించడానికి పై
shared an array of happy as her instagram account million followers	తన వారి సంఖ్య మిలియన్లు కృతజ్ఞతలు చెబుతూ ఓ ఫొటోను షేర్ చేశారు
the bharat bond exchange fund is the first corporate bond in the country	కాగా భారత్ బాండ్ వాణిజ్య మార్పిడి నిధి దేశంలో తొలి కార్పొరేట్ బాండ్ అవుతుంది
indrakaran reddy srinivas yadav reddy and others took oath as ministers	అల్లోల ఇంద్రకరణ్ రెడ్డి జి శ్రీనివాస యాదవ్ లు ఉన్నారు
batting put on runs for the loss of five wickets in their allotted overs	ఇదిలా ఉండగా తొలుత టాస్ బ్యాటింగ్ చేసిన భారత్ నిర్ణీత ఓవర్లలో ఎనిమిది వికెట్లు కోల్పోయి పరుగులు చేసింది
the modi government has opened the door for of foreign capital in the country	ఇండియా వదిలేసి విదేశీ తలుపులు ప్రభుత్వం
nicobar islands are likely to experience heavy rainfall at isolated places on rd may	నికోబార్ మే నెల రెండు మూడు తేదీల్లో భారీ వర్షాలు పడే
yes it does if you want to practice the taught in the bible itself	అవును ఒకవేళ మీరు బైబిల్లో ఉన్న విషయాలు అవసరమే
as a result most rural areas are dominated by a small set of families	ఈ కారణంగా గ్రామీణ ప్రాంతాలు చిన్న స్థాయి భూస్వామ్య ఉన్నాయి
metro man pm not to agree to delhi govts free travel scheme for women	ఢిల్లీ మెట్రో మహిళలకు ఉచితం ప్రయాణం ప్రతిపాదనను లేఖ రాసిన మెట్రో
following the ceremony joe has officially become the th president of the united states	వాషింగ్టన్ అమెరికాకు వ అధ్యక్షుడిగా బాధ్యతలు జో ప్రమాణ కార్యక్రమానికి ముందే తన సిద్ధం చేసుకున్నారు
to root out such and to put on the new personality takes effort	అలాంటి గట్టిగా ఉంటుంది
according to the group pm modi is his people for a future war against muslims	ప్రకారం మోడీ పైన యుద్ధానికి తమ సిద్ధం చేస్తున్నారు
he established the school of dramatic arts and became the principal of academy	తరువాత స్కూల్ ఆఫ్ ఆర్ట్స్ ను ప్రిన్సిపాల్ గా
after making a weak shares of the company plunged per cent to rs on bse	అయిన షేర్లు శాతం క్షీణించి రూపాయలకు చేరాయి
congress president sonia gandhi has called upon the leaders of party leaders to join the meeting	సోనియా గాంధీ సమావేశానికి పార్టీలకు చెందిన నేతలు హాజరయ్యారు
if you created or a file but now you cant find it follow these tips	మీరు సృష్టించి లేదా దిగుమతి దానిని ఇప్పుడు ఈ కింది
the union leaders reddy chandrasekhar reddy venkateshwarlu and others attended the meeting	ఈ కార్యక్రమంలో బిసి నాయకులు కోట్ల శ్రీనివాస్ సి తదితరులు పాల్గొన్నారు
the phones come in crush red crush black and crush white colour options	రెడ్ బ్లాక్ వైట్ రంగుల్లో ఈ మొబైల్ లభిస్తుంది
bjp three remaining lok sabha seats in jammu and kashmir including jammu and ladakh	ఆరు లోక్సభ స్థానాల్లో లడఖ్ జమ్మూ స్థానాలను బీజేపీ కైవసం
while the upa had planned to buy fighter aircraft the nda decided to purchase only	ప్రభుత్వం యుద్ధ విమానాలను కొనుగోలు చేయాలని ప్రధాని మోడీ కేవలం కొనుగోలు చేయాలని దేశ భద్రతకు సంబంధించిన వ్యవహారంపై
in a add cream milk and sugar and mix well till the sugar completely	ఒక పాత్రలో పాలు పంచదార కోకో పొడి వేసి స్టౌ మీద ఉంచి పంచదార బాగా కలుపుకోవాలి
bombay shirt co currently has two stores in mumbai one in bengaluru and one in delhi	ఇప్పటికే ముంబైలో ఒక షోరూమ్ ఢిల్లీలో రెండు ఉన్నాయి
on wednesday december the international cricket council icc announced the full list of its annual awards	ఈ మేరకు బుధవారం డిసెంబర్ న ఐసీసీ జాబితాను ప్రకటించింది
the opposition captain virat kohli might be playing country cricket in england during the bengaluru test	ఇకపోతే కెప్టెన్ విరాట్ కోహ్లీ ఇంగ్లాండ్ తో జరగనున్న క్రికెట్ మ్యాచ్ లలో
after the formation of the telangana state the government had declared as a state festival	తెలంగాణ ప్రత్యేక రాష్ట్రం ఏర్పడిన తరువాత రాష్ట్ర నిర్వహిస్తున్నారు
while and madhukar died on the spot suresh died while undergoing treatment in a hospital	ఈ ప్రమాదంలో రజనీకాంత్ మధుకర్ అక్కడికక్కడే చనిపోగా ఆస్పత్రికి ప్రాణాలు
it is to watch the totonac indians do the work of pollinating the flowers	వారు ప్రతి కేవలం కొన్ని పుష్పాలలో మాత్రమే పుప్పొడిని
cm jagan directed the dgp and to be more vigilant about the safety of women	మహిళల భద్రత పట్ల మరింత జాగ్రత్తగా ఉండాలని డీజీపీ లను జగన్ ఆదేశించారు
ysr congress party chief ys jagan mohan reddy s yatra reached vijayanagaram successfully	విజయవాడ అధినేత వైఎస్ జగన్ చేపట్టిన విజయవంతంగా సాగుతుంది
method in a small pan heat the olive oil and add onions and garlic	విధానం పాన్లో నూనె వేసి ఉల్లిపాయ వేసి
the party needs at least mlas to retain the leader of opposition status in the assembly	అందువల్ల ప్రతిపక్ష హోదా కావాలంటే కనీసం మంది ఎమ్మెల్యేలు ఉండాలి
the court declined to pass any judgement on the mention of bose and his death	మరణం గురించి కాని ప్రస్తావన గురించి కాని ఎటువంటి వ్యాఖ్యలు చేయడానికి నిరాకరించింది
it formed government in up uttarakhand manipur and goa while in punjab the congress came to power	ఇటీవల జరిగిన ఐదు రాష్ట్రాల ఎన్నికల్లో ఉత్తరప్రదేశ్ మణిపూర్ గోవా ఉత్తరాఖండ్లలో బీజేపీ ప్రభుత్వం ఏర్పాటు చేయగా పంజాబ్లో మాత్రం కాంగ్రెస్ పార్టీ అధికారంలోకి వచ్చింది
football is a massive sport all over the world played and watched by millions of fans worldwide	ప్రపంచంలో అత్యధిక ఆదరణ పొందిన ఉన్న కోట్లాది మంది అభిమానులు ఉన్నారు
ncp chief sharad pawar cpm general secretary sitaram yechury and s reddy attended the meeting	సీపీఎం జాతీయ ప్రధాన కార్యదర్శి సీపీఐ జాతీయ ప్రధాన కార్యదర్శి ఆమ్ పార్టీ అధ్యక్షుడు కేజ్రీవాల్ మాత్రమే హాజరయ్యారు
indian skipper virat kohli the top spot in batting in the recent icc odi player rankings	దీంతో ఐసీసీ తాజాగా ప్రకటించిన ర్యాంకింగ్స్లో భారత పరుగుల విరాట్ కోహ్లి అరుదైన ఘనతను అందుకున్నాడు
so let us now continue to strengthen our faith and to work whole as to jehovah	కాబట్టి మన యెహోవా సేవ చేసేందుకు చేయగలిగినదంతా చేద్దాం
however upper caste candidates are in the lists of the trs the congress and the bjp	అయితే టీఆర్ఎస్ కాంగ్రెస్ బీజేపీ అభ్యర్థులు ఓటర్లకు భారీగా
farmers group help farmers group in different locations across the city provides fruit vegetables to citizens	రైతు సహాయం నగరంలోని వేర్వేరు ప్రదేశాలలో రైతు పౌరులకు పండ్లు అందిస్తోంది
he first won as village sarpanch and later as samithi president and then as a bank chairman	మొదట గ్రామ సర్పంచ్ గా తరువాత సమితి అధ్యక్షుడిగా తరువాత బ్యాంక్ చైర్మన్ గా గెలిచాడు
she was working as a teacher in a government school in the area of district	ఆమె గతంలో జిల్లాలో ప్రభుత్వ పాఠశాలలో ఉద్యోగం చేసేవారు
the state reported new cases taking the state overall tally to and number of active cases to	రాష్ట్రంలో కొత్త కేసుల మొత్తం కేసుల సంఖ్య కు యాక్టివ్ కేసుల సంఖ్య కు చేరాయి
the student team age of which comprised of six members under the guidance of dr	ఆరుగురు విద్యార్థులతో కూడిన బృందం తొలి బహుమతి లక్ష రూపాయలను గెలుచుకుంది
the indian army launched a against the firing and retaliated strongly to pakistans	పాక్ దాడులను భారత సైన్యం ఇరువైపులా భారీగా కాల్పులు జరిగాయి
prashant who in is working in the movie babu	నివాసం ఉంటున్న బాబు సినిమా హీరోగా నటిస్తున్నాడు
mumbai profit booking negative global and a weakened rupee depressed the indian equity markets on tuesday	ముంబై అంతర్జాతీయ మార్కెట్ల ప్రతికూల సంకేతాలు దేశీయ పరిణామాల నేపథ్యంలో స్టాక్ మార్కెట్లు మొదలయ్యాయి
out of the cases by it the sit by its own account reopened investigation in only	సిట్ ఇప్పటి వరకు కేసులను పరిశీలించి అందులో కేవలం కేసులను తిరిగి ప్రారంభించింది
maruti suzuki is looking for a bigger market share in the suv segment in the indian market	మారుతి సుజుకి దేశీయ పెద్ద అత్యధిక మార్కెట్ సొంతం చేసుకోవడానికి ప్రయత్నిస్తోంది
the state ranks first in the country in production of oilseeds gram garlic and tomatoes	రాష్ట్రం మామిడి బొప్పాయి నిమ్మ టమోటా పసుపు దేశంలోనే రాష్ట్రం మొదటి స్థానంలో ఉందన్నారు
on the other hand metal power basic materials energy and auto gained up to per cent	మరోవైపు శాతం లాభపడ్డాయి
as for the and space the celerio is practical and ease to drive is good	వెనుక భాగం గురించి రూమ్ మరియు హెడ్ రూమ్ ఎంతో సౌకర్యవంతంగా విశాలంగా ఉంటుంది
prime a street dog was often seen hanging out near a hyundai car in brazil	ప్రైమ్ ఒక వీధి బ్రెజిల్ దేశంలోని హ్యుందాయ్ షోరూమ్ దగ్గర తరచూ
superstar mahesh babu is celebrating his birthday and all of social media went viral about the actors birthday	టాలీవుడ్ సూపర్ స్టార్ మహేష్ బాబు పుట్టిన రోజు సందర్భంగా సోషల్ మీడియా మోత
at am on december the earth five miles km south of the city of in iran	డిసెంబరు ఉదయం గంటలకు దక్షిణాన ఎనిమిది కిలోమీటర్ల దూరంలో భూమి
soon officials of fire and emergency department reached the spot and fire tenders to control the fire	సమాచారం వెంటనే అగ్నిమాపక సిబ్బంది అక్కడకు చేరుకుని అదుపు చేశారు
starring abhishek bachchan taapsee pannu and vicky kaushal in the lead role is directed by anurag	పన్ను కౌశల్ అభిషేక్ బచ్చన్ ప్రధాన పాత్రల్లో నటించిన చిత్రానికి అనురాగ్ దర్శకత్వం వహించారు
therefore people must their by looking forward to celebrating these festivals in a different way	అందువల్ల ప్రజలు ఈ వేరే విధంగా ద్వారా వారి
these laws include not to lie not to not to murder and not to commit	పిల్లలు ఒక కారణం ఏమిటి
the temple is included among the the temples of vishnu celebrated by the poet	ఈ ఆలయాన్ని మంది కవి నిర్వహించే దేశం విష్ణు
and here we look at only the possible ways in which the causes and combine to produce effect	మరియు మనము ఇక్కడ కారణాలు మరియు కలిపి మిళితం చేస్తే వచ్చే సాధ్యమైన మార్గాలు మాత్రమే చూస్తాము
indeed israel a long history of by jesus at which point jehovah rejected them matthew	అవును యేసును ద్వారా తిరుగుబాటు చరిత్రను ఆ సమయంలోనే యెహోవా వారిని మత్తయి
in petrol price rose to rs while diesel price was hiked by paise to rs per litre	పైసలు ముంబైలో పెట్రోల్ ధర రూ
pm announces setting up of task force to prepare action plan for the next three olympic games and	ఒలింపిక్స్ కార్యాచరణ టాస్క్ ఫోర్స్ ప్రధాని ప్రకటన
de la known to those on the island as simply is its capital	దీని రాజధాని డి లా కేవలం గా
the news of her sad demise was revealed to the world by her brother rishi kapoors daughter kapoor	ఈ సందర్భంగా రిషి కపూర్ కూతురు కపూర్ తండ్రి విచారం వ్యక్తం చేశారు
was put under detention after an court granted him bail in the mumbai attacks case on december	ముంబై దాడులకు ఉర్ కారణమంటూ సరైన ఆధారాలు తీవ్ర వ్యతిరేక కోర్టు డిసెంబర్ న బెయిల్ మంజూరు చేసిన విషయం తెలిసిందే
shops in market except those within the limits of municipal corporations and municipalities would be allowed to open	మునిసిపల్ మినహా అన్ని మార్కెట్ దుకాణాలు
the state of assam has witnessed protests since the of the bill in the lok sabha last month	గతేడాది పార్లమెంట్ సమావేశాల్లో బిల్లును అసోం రాష్ట్రంలో ఆందోళనలు మిన్నంటాయి
sye raa is directed by surender reddy and is based on the life story freedom fighter uyyalawada narasimha reddy	ఉయ్యాలవాడ సైరా జీవిత కథ ఆధారంగా సైరా సినిమా తెరకెక్కుతున్న విషయం తెలిసిందే
the team comprised professor sc sharma dr kumar mr mr singh mann mr sharma	ఈ ప్రొఫెసర్ కుమార్ ప్రొఫెసర్ కె ప్రొఫెసర్ ఎ వి సింగ్ ప్రొఫెసర్ హెచ్ రాజశేఖర్ ప్రొఫెసర్ డి ఆర్ ప్రొఫెసర్ శర్మ ప్రొఫెసర్ ఉన్నారు
the ncp congress and shiv sena tied up to form the government in maharashtra after last years assembly elections	కాగా గతేడాది మహారాష్ట్ర జరిగిన ఎన్నికల్లో ఏ పార్టీకి స్పష్టమైన మెజారిటీ కాంగ్రెస్ శివసేన ఎన్సీపీ కలిసి సంకీర్ణ ప్రభుత్వాన్ని ఏర్పాటు చేశాయి
can be added to the sodium solution in order to and thus prevent	కరిగిన పదార్థాలను తిరిగి నివారించడానికి సోడియం
costa scored the goal of the match to maintain winning streak in the english premier league	జరిగిన మ్యాచ్లో చేసిన సింగిల్ గోల్ తో ఈ రికార్డు
the psychological thriller insomnia starring al and williams was shot in canada but was set in	చిత్రం ఆల్ విలియమ్స్ నటించిన చిత్రం
christian and a small number of and jews make up the of the population	క్రిస్టియన్ నివసిస్తున్నారు
the expression the of truth is in hebrew and has a meaning than just truthful speech	అది స్థిరత్వం విశ్వసనీయత వంటి లక్షణాలను సూచిస్తుంది అని ఒక గ్రంథం చెబుతోంది
andhra pradesh government the report of south korean automobile giant motors moving its plant out of andhra pradesh	మోటార్స్ కార్ల పరిశ్రమ ఆంధ్రప్రదేశ్ నుంచి ప్రచారాన్ని దక్షిణ కొరియా ప్రభుత్వ అత్యున్నత వాణిజ్య విభాగం
of the half tribe of manasseh in gilead the son of zechariah of benjamin the son of	మనష్షే జెకర్యా కుమారుడైన కుమారుడైన
she is mainly worshipped as a south indian mother goddess predominantly in the rural areas of telangana karnataka and maharashtra	ఈ తెలంగాణ కర్ణాటక మహారాష్ట్ర గ్రామీణ ప్రజలు ఎక్కువగా
the heavy rainfall on sunday evening left many streets in the city under of water and affected traffic movement	ఆదివారం సాయంత్రం నగరంలోని పలు ప్రాంతాల్లో మోస్తరు నుంచి భారీ వర్షం
and after was the son of and and the general of the kings army was	కుమారుడైన సేనకు
the bible speaks of jesus christ as having life in himself and of his followers as having life in themselves	యేసుక్రీస్తు డు అని ఆయన అనుచరులు తమలో తాము అని బైబిలు చెబుతోంది
later on wardha was ruled by delhi muslim ruler of and	తరువాత చెందిన యాదవులు ఢిల్లీ చెందిన ముస్లిం పాలకులు పాలించారు
during the th and th centuries numerous bridges connected the banks of the the most famous being old london bridge	నదిని అనేక వంతెనలు వాటిలో లండన్ బ్రిడ్జి అత్యంత
these rapidly large water as energy transfers to the water at a rate faster than the water can	ఈ ఒకేసారి చాలా నీటిని పడుతున్న వ్యర్థాల నుండి శక్తి లేదా చెంది సముద్రం వాటిని త్వరగా పడతాయి
the kapil cricket advisory committee named ravi shastri again as the new head coach of the indian cricket team	కపిల్దేవ్ నేతృత్వంలోని క్రికెట్ సలహా కమిటీ టీమిండియా ప్రధాన తిరిగి నియమించారు
new delhi the andhra pradesh government is planning to launch an named after once the state capital is developed	అమరావతి అమరావతి నగర కార్యక్రమాన్ని అన్న విధంగా జరపాలని ఆంధ్రప్రదేశ్ ప్రభుత్వం
the pakistan cricket board is on appointing former captain as head of the national team	పాకిస్థాన్ మాజీ సారథి ఉల్ పాక్ జట్టు చీఫ్ పాకిస్థాన్ క్రికెట్ బోర్డు ఆసక్తి సమాచారం
the government is committed to early of gst one of the biggest reforms in the country as early as possible	ఒక సంస్కరణ టి ని దేశంలో ప్రభుత్వం కట్టుబడి ఉంది
the supreme court is expected to deliver the verdict in ram masjid title dispute case in the next couple of days	సాగుతున్న బాబ్రీ మసీదు కేసులో మరి కొన్ని గంటల్లో సుప్రీం కోర్టు తీర్పు
i get up early and witness to people at bus stops in parking lots on the street in shops or in parks	నేను లేచి పార్కింగ్ ఇస్తున్నాను
the block education officer filed a complaint against pawan jaiswal a journalist and a representative of the village head rajkumar pal	టైమ్స్ స్థానిక పవన్ పాటు ప్రధాన్ ప్రతినిధి రాజ్కుమార్ కేసు నమోదు చేశారు
jehovah would not just anyone but only those walking and practicing and speaking the truth in their heart	అది సంబంధం మార్గాన్ని చేస్తుంది
cbi judge singh pronounced the sentence in a special set up inside sunaria jail where ram is lodged	రోహ్తక్ జైలులో ఓ ప్రత్యేక సీబీఐ కోర్టు న్యాయమూర్తి జస్టిస్ ఈ ఖరారు చేశారు
gauri khan the wife of bollywood star shah rukh khan has a for herself in the field of interior design	బాలీవుడ్ షా ఖాన్ భార్య గౌరీ ఖాన్ లో ఎక్స్ అన్న విషయం తెలిసిందే తాను డిజైన్ చేసిన
leaves after a few days and stays until the night of the party when he is found by easy	కొద్ది రోజుల తరువాత పటేల్ ప్రకారం స్వాగతం ఉండగా ముందు అందుకు
the government has given the option for people who live close to the rivers to carry in bullock for free	నదీ పరిసర ప్రాంతాల ప్రజలు సొంత కోసం ఉచితంగా తీసుకెళ్లే వెసులుబాటును ప్రభుత్వం కల్పించింది
further if you are buying or selling a property worth more than lakh of the value is as tds by the	లక్షలు లేదా అంతకంటే ఎక్కువ ఉన్నప్పుడు కొనుగోలు ఆస్తి విలువను శాతం చేయాలి
top losers in the sensex pack included indusind bank yes bank sbi lt tata steel mm bajaj finance vedanta tata motors and ril	నష్టపోయిన ఇతర షేర్లలో బ్యాంక్ యెస్ బ్యాంక్ ఎస్బీఐ ఎల్ అండ్ టీ టాటా స్టీల్ మహీంద్రా బజాజ్ ఫైనాన్స్ టాటా మోటార్స్ ఉన్నాయి
on the occasion of andhra pradesh governor sri harichandan conveyed his warm greetings and good wishes to the people	సందర్భంగా గవర్నర్ భూషణ్ హరిచందన్ ప్రజలకు శుభాకాంక్షలు తెలిపారు
par is an island group of and two small located approximately km south of island	ఐలాండ్ కు సుమారు కి మీ ల దూరంలో మరియు అనే రెండు చిన్న కలసి అనే దీవి ఏర్పరచాయి
to come early in attempt to use their on himself he is killed by the sisters survived him	యొక్క ఇద్దరు కుమారులు వారి వారిని
after three months we set in a ship of which had in the island whose sign was the twin brothers	మూడు తరువాత ఆ ఓడ ఎక్కి బయలుదేరి
was the of and the only child of king and queen of the kingdom	ఈమె రాజ్యాన్ని రాజా రాణి ల ఏకైక
atom capable of hurling particles of matter at one another now offer scientists a glimpse inside the nucleus of the atom	వంటి పేర్లు ఇలాంటివి ఇంకా అనేకం ఉన్నాయి
pooja hegde and prabhas new movie shyam is an upcoming indian romantic drama actors prabhas and pooja hegde in lead roles	యంగ్ స్టార్ హీరోగా పూజా హెగ్డే హీరోయిన్ గా నటిస్తున్న లేటెస్ట్ అండ్ పాన్ ఇండియన్ చిత్రం శ్యామ్
awareness through covid awareness message is being published for citizens on variable placed at critical of the city	ద్వారా అవగాహన నగరంలోని ముఖ్యమైన ఉన్న మెసేజింగ్ ద్వారా అవగాహన
the architecture of the temple gives us a glimpse into skills and of the people in assam during the rule	ఈ ఆలయ వాస్తు శైలి లో వంశ ప్రజల నిలుస్తుంది
the temple in dates back to the th century and is dedicated to the worship of lord shiva	లో ఆలయం వ శతాబ్దం ఇక్కడ పూజిస్తారు
at launch had an storage capacity offer of one per user a significantly higher amount than offered at the time	ప్రారంభించినప్పుడు ఒక యొక్క ప్రారంభ నిల్వ సామర్థ్యాన్ని కలిగి ఉంది ఆ సమయంలో అందించే కంటే ఇది చాలా ఎక్కువ
jeff bezos amazon ceo and the worlds persons smartphone the iphone x was reportedly hacked by saudi arabia prince through a whatsapp message	ప్రపంచంలో నంబర్ వన్ అమెజాన్ ఓనర్ జెఫ్ బెజోస్ వాట్సాప్ చేశారని
the cbi has taken over the probe in three cases related to the alleged rape of a yearold girl by bjp mla kuldeep singh sengar	సంచలనం సృష్టిస్తున్న కేసులో బీజేపీ ఎమ్మెల్యే అరెస్ట్ చేసింది సీబీఐ ఏళ్ల బాలికపై అత్యాచారం కేసులో ఉత్తర ప్రదేశ్ పోలీసులు ఇప్పటికే కేసులు నమోదు చేశారు
the defence needs of the country the needs and interests of those who protect the country is one of the highest of our government	మిత్రులారా దేశ రక్షణ అవసరాలను జాగ్రత్తగా దేశాన్ని వారి అవసరాలను వారి జాగ్రత్తగా అనేది మన ప్రభుత్వానికి అత్యధిక అంశం
the soldiers then took him to a military camp where after he was beaten for four days one of them shot him in the leg	కానీ బైబిలు శిక్షణ పొందిన తన మూలంగా ఆయన చేరేందుకు
during the major focus of the programme would be on mass awareness programme for farmers in over lakh villages covering all districts of the country	ఈ కార్యక్రమం కింద మధ్య దేశంలోని లక్ష గ్రామాల్లో రైతుల కోసం సామూహిక అవగాహన దృష్టి ప్రకటించారు
australia david warner aaron finch captain steven smith ashton turner alex carey ashton pat cummins mitchell adam zampa	ఆస్ట్రేలియా జట్టు కెప్టెన్ డేవిడ్ వార్నర్ స్టీవ్ స్మిత్ మాక్స్వెల్ అలెక్స్ క్యారీ ప్యాట్
his identity may the world in general but it is no mystery to us who was the most important person ever born in	ఇంతవరకు అత్యంత వ్యక్తి ఎవరు
however it was the bjp which is all set to form government in four states except for the congress managed to win seats out of	ఒక్క పంజాబ్ తప్ప మిగిలిన నాలుగు బీజేపీ స్పష్టంగా
congress president rahul gandhi and gandhi must apologise for seeking to hindu religion by the terror term alleged bjp spokesperson	హిందూ లాంటి కాంగ్రెస్ అధ్యక్షుడు రాహుల్ గాంధీ ఆయన తల్లి సోనియా క్షమాపణలు చెప్పాలని బీజేపీ అధికార ప్రతినిధి డిమాండ్ చేశారు
in several countries where regulations are in place alternative of are in the medical community and are offered by medical doctors	చికిత్సా విధానాలు చేయబడిన అనేక దేశాల్లో ప్రత్యామ్నాయ చికిత్సా విధానాలు సాంప్రదాయ వైద్య ఆమోదాన్ని వైద్యులు వాటిని అందిస్తున్నారు
today both and records remain a part of the foundation of our faith and a to the of the promises of god	యేసు వంశావళి గురించి మత్తయి ఉన్న వివరాలు
customers looking for deliveries after september can still book the motorcycles at the motorcycle check out the differences between the two motorcycles here	సెప్టెంబరు తర్వాత డెలివరీ కోసం వినియోగదారులు అధికారం కలిగిన మోటార్ సైకిల్ మోటార్ బుక్ చేసుకోవచ్చు
he too had remembered his grand creator in the days of his young having dedicated his life to jehovah in when he was years of age	ఆయన కూడా తన మహా గొప్ప తన యౌవనంలోనే తెచ్చుకున్న వ్యక్తి సంవత్సరంలో ఆయనకు సంవత్సరాల ఆయన తన జీవితాన్ని యెహోవాకు
new delhi the supreme court on friday referred to its constitution bench the matter to a ban on the entry of women at historic temple	సాక్షి న్యూఢిల్లీ ఆలయ కేసును బదిలీ చేస్తూ దేశ అత్యున్నత న్యాయస్థానం శుక్రవారం తీర్పు ఇచ్చింది
the madhya pradesh government too has taken the initiative and opened a facing the dam which gives a breathtaking view of the entire dam and the	మధ్యప్రదేశ్ ప్రభుత్వం కూడా ఈ ని పర్యాటక ప్రాంతం గా ప్రసిద్ది చేసేందుకు ఈ కి ఎదురుగా ఒక ని నిర్మించింది
he was accompanied by up cm yogi adityanath bihar deputy cm sushil modi and uttarakhand cm singh rawat at the atal ghat as well as in the meeting	ఈ బోటు యూపీ సీఎం ఉత్తరాఖండ్ సీఎం సింగ్ రావత్ బీహార్ డిప్యూటీ సీఎం మోడీ ప్రధాని వెంట ఉన్నారు
the governments selfreliance goals for the included the three most sophisticated and challenging systems the flight control system and engine	కోసం మూడు అత్యంత ఉన్నాయి ఫ్లైట్ కంట్రోల్ సిస్టమ్ కలిగిన ఇంజిన్
the main features of new policy regime are revenue sharing contract single for exploration and production of as well as resources marketing pricing freedom etc	నూతన విధానం రాబడి కాంట్రాక్టు మరియు వనరుల ఒకటే లైసెన్సు మార్కెటింగ్ ధరల నిర్ణయం వంటివి ముఖ్యమైనవి
then ruler of in the former but the remaining and in the former of and rejected offer	మాజీ అప్పటి దీనిని మాజీ మిగిలిన గిరిజన ప్రతిపాదనను తిరస్కరించారు
new syllabus three of uniform a pair of shoes two of socks a and a are being provided as part of the kit	కొత్త కూడిన పుస్తకాలు మూడు ఒక జత రెండు వంటి పలు రకాల కొందరు అందించారు
hyderabad ysrcp chief and leader of opposition ys jagan mohan reddy is walking in the footsteps of his father and late chief of united andhra pradesh dr ys reddy	హైదరాబాద్ ముఖ్యమంత్రి పదవిని కడప పార్లమెంటు సభ్యుడు జగన్మోహన్ రెడ్డి తన తండ్రి దివంగత కాంగ్రెసు నేత రెడ్డి
in the southern united states and are popular as are and pigs feet chicken eggs eggs garden vegetables and	దక్షిణ యునైటెడ్ స్టేట్స్లో మరియు ముక్కలు ఆదరణ ఉంటున్నాయి బాగా మరియు పంది కాలు చికెన్ గుడ్లు గుడ్లు మరియు రూపంలో ఇవి అందుబాటులో ఉంటున్నాయి
a solution has grams of per grams of liquid or to put it another way grams of sugar and grams of water exist in the grams of solution	ఒక ప్రతి గ్రాముల ద్రవంలో గ్రాముల ఉంటుంది లేదా చెప్పాలంటే గ్రాముల గ్రాముల మరియు గ్రాముల నీరు ఉంటుంది
in the th century if he was close to the garden when he on the island of now the dominican republic and	ఇప్పుడు అది ఒక వరల్డ్ హెరిటేజ్ సైట్
the loan amount is to a maximum of per cent of the balance in your account at the end of the first financial year where in if you opt for rd year	మొదటి ఏడాది ఖాతాలో ఉన్న మొత్తంలో శాతం వరకూ మూడో ఏడాది పొందవచ్చు
it is bordered by telangana to the west chhattisgarh to the north odisha to the northeast tamil nadu to the south karnataka to the west and the bay of bengal to the east	దీనికి తెలంగాణ ఉత్తరాన ఛత్తీస్గఢ్ ఒడిషా దక్షిణాన తమిళనాడు పశ్చిమాన కర్ణాటక తూర్పున
their columns some feet m wide are edged by spiders and and are followed by birds which on these but not on the ants	పక్షులు కానీ
and ye shall keep it a feast unto the lord seven days in the year it shall be a statute for ever in your generations ye shall celebrate it in the seventh month	మీరు ఏడు దినములు యెహోవాకు ఇది మీ ఏడవ నెలలో దానిని
and all nations shall serve him and his son and his sons son until the very time of his land come and then many nations and great kings shall serve themselves of him	అతని కాలము అతని అతని కుమారుని ఆ కాలము రాగా
according to the results updated on the election commission website late tuesday night sharan alias has votes while the alias shakti singh yadav has got votes	జేడీయూ నుంచి పోటీ చేసిన శరణ్ అలియాస్ ఓట్లు ఆర్ జేడీ పార్టీ నుంచి పోటీ చేసిన ముని అలియాస్ కు ఓట్లు ఎన్నికల అధికారులు తెలిపారు
for example the him as who the god of love in the ocean in the lord of heaven in in and in	ఆయన రాజు అని లోతైన వ్యక్తి అని ఆయన ఆయనను
the government had slashed the corporate tax rates to per cent for domestic companies and per cent for new domestic manufacturing companies as well as announcing and other fiscal in order to promote growth and investment	వృద్ధి పెట్టుబడులను దేశీయ కార్పొరేట్ పన్ను శాతానికి నూతన తయారీ రంగ సంస్థలు శాతం పన్ను అవకాశం కేంద్ర మంత్రి ప్రకటించారు
the days as cold wave days in the if the minimum temperature is degrees celsius or lower and at the same time degrees or more below the average minimum temperature for the day for two consecutive days	డిగ్రీల లేదా అంతకంటే ఉష్ణోగ్రతలు ఉన్నప్పుడు వరుసగా రెండు రోజులు కన్నా తక్కువ చల్లని
ministry of power ntpc highest daily gross generation of as per a statement by ntpc ltd a psu under ministry of power and countrys largest power generation company it has achieved highest daily gross generation of million unit on th july	విద్యుత్తు మంత్రిత్వ శాఖ రికార్డు స్థాయిలో మిలియన్ యూనిట్ల రోజువారీ సాధించిన ఎన్టీపీసీ దేశంలోనే అతి పెద్ద విద్యుత్ ఉత్పత్తి సంస్థ అయిన నేషనల్ పవర్ కార్పొరేషన్ మరో ఘనతను సాధించింది ఆ సంస్థ ప్రకటన ప్రకారం మిలియన్ యూనిట్ల రోజువారీ రికార్డు సృష్టించింది
