ambhi then ruler of taxila in the former hindush satrapy complied but the remaining tribes and clans in the former satraps of gandhara arachosia sattagydia and gedrosia rejected alexanders offer	మాజీ హిందూషు సాత్రపీలోని అప్పటి టాక్సిలా పాలకుడు అంబి దీనిని అంగీకరించినప్పటికీ గాంధారా అరాచోసియా సత్తాగిడియా గెడ్రోసియా మాజీ సాత్రపీలో మిగిలిన గిరిజన వంశాలు అలెగ్జాండరు ప్రతిపాదనను తిరస్కరించారు
but the information leaked	అయితే సమాచారం లీకు అయింది
bjp represents three remaining lok sabha seats in jammu and kashmir including jammu udhampur and ladakh	జమ్మూకాశ్మీర్లోని ఆరు లోక్సభ స్థానాల్లో లడఖ్ జమ్మూ ఉదంపూర్ స్థానాలను బీజేపీ కైవసం చేసుకున్నది
green chilli finely chopped	గ్రీన్ క్యాప్సికమ్ సన్నగా కట్ చేసుకోవాలి
how do you select the stories	ప్ర  మీరు కథలను ఎలా ఎంపిక చేసుకుంటారు
its no laughing matter	నవ్వితే ఏం ప్రమాదం లేదు
in the past decade	గత దశాబ్ద కాలంగా
increasing cases	కేసులు పెరగడానికి
he later became a software engineer	ఇతను సాఫ్ట్ వేర్ ఇంజనీరుగా పనిచేస్తూ తర్వాత నటుడిగా మారాడు
in a time of emergency one cannot live a normal life	మరి తప్పేమిటి
but everybody had heard of it	కానీ అందరూ ఆయన్ని చాలా మాటలన్నారు
bought health insurance policy	ఆరోగ్య బీమా పాలసీ తీసేసుకున్నాం కదా
ensuring timely completion of projects	సకాలంలో ప్రాజెక్టుల పూర్తికి ప్రణాళిక
where is happiness located	మీకు ఆనందం ఎక్కడ దొరుకుతుంది
the scooter gets two different riding modes sport and ride	స్కూటర్లో ఎకో స్పోర్ట్ అనే రెండు మోడ్స్ ఉంటాయి
use light colours	తటస్థ రంగుని ఉపయోగించండి
so i went to the hospital	అందుకే ఆస్పత్రికి వెళ్లాను
even rs	గోవాకు రూ
people injured as bus falls into pit	అదుపుతప్పి బోల్తా పడిన బస్సు  మందికి గాయాలు
i like his acting	అయన నటన అంటే నాకు ఇష్టం
the victim was sent to a hospital for treatment	దీంతో ఆ రోగిని అత్యవసర విభాగంలోకి తరలించారు
it is being directed by rahul sankrityayan	రాహుల్ సాంక్రిత్యాన్ దర్శకత్వంలో శ్యామ్ సింగారాయ్ అనే సినిమా చేస్తున్నాడు
per cent	కొయ్యూరు  శాతం
fifteen houses collapsed under the impact of the explosion	పేలుడు ధాటికి చుట్టుపక్కల ఉన్న ఐదు ఇండ్లు ధ్వంసం అయ్యాయి
here are the videos and pictures	ఆ ఫోటోలు వీడియోల సమాహారం మీకోసం
underlying it	దాని ఆధారంగా
pawan kalyan stages performances under chandrababus direction	చంద్రబాబు డైరెక్షన్లో నటిస్తున్న పవన్ కళ్యాణ్
not to miss	తామేవీ కోల్పోవడం లేదు
he was surprised	అని ఆశ్చర్యపోయాడు
modi along	మోదీతో దీదీ
the ncp congress and shiv sena tied up to form the government in maharashtra after last years assembly elections	కాగా గతేడాది మహారాష్ట్ర అసెంబ్లీకి జరిగిన ఎన్నికల్లో ఏ పార్టీకి స్పష్టమైన మెజారిటీ లభించకపోడంతో కాంగ్రెస్ శివసేన ఎన్సీపీ కలిసి సంకీర్ణ ప్రభుత్వాన్ని ఏర్పాటు చేశాయి
she was admitted at a hospital	ఆమెను ఆసుపత్రిలో చేర్పించగా కోలుకుంది
iphone c	ఐఫోన్  కెమెరాలు
in so doing we learn the limits of pure reason	ఈ శ్రద్ధ వలన మాత్రమే సత్యదర్శనం సంభవమవుతుంది
while the congressled upa had planned to buy fighter aircraft the nda decided to purchase only	యూపీఏ ప్రభుత్వం  యుద్ధ విమానాలను కొనుగోలు చేయాలని నిర్ణయించగా ప్రధాని మోడీ కేవలం  విమానాలనే కొనుగోలు చేయాలని నిర్ణయించి దేశ భద్రతకు సంబంధించిన వ్యవహారంపై రాజీపడ్డారు
the two vehicles collided headon	రెండు వాహనాలు ఒకదానికొకటి ఇరుక్కుపోయి అక్కడే నిలిచిపోయాయి
so keep smiling	ఐతే అలా నవ్వుతావేం
opposition leaders criticized the government	రాష్ట్ర ప్రభుత్వంపై విపక్షాలు తీవ్ర విమర్శలకు దిగుతున్నాయి
maruti suzuki has announced a price hike on its entire lineup in the indian market	మార్కెట్ లీడర్గా మారుతి సుజుకి ఇప్పటికే ధరల పెంపును ప్రకటించిన సంగతి తెలిసినదే
history to munch on	చరిత్ర ఆర్ ఫిక్షన్
digvijay singh file photo	దిగ్విజయ్ సింగ్ ఫైల్ ఫొటో
later she was taken to government general hospital in guntur	ఆ తర్వాత చికిత్స ఖర్చు భరించే స్థోమత లేక గుంటూరు ప్రభుత్వ దవాఖానలో చేర్పించారు
the man guffawed	మనిషి లావయింది
the other mp	మరో ఎంపీ కూడా
so is china	అలాగే చైనా కూడా
bollywood actress tanushree dutta recently accused veteran actor nana patekar of sexual harassment	బాలీవుడ్ నటి తనుశ్రీ దత్తా ఇటీవల నటుడు నానా పటేకర్ పై లైంగిక వేధింపుల ఆరోపణలు చేయడంతో మీటూ క్యాంపెయిన్ మరోసారి తెరపైకి వచ్చింది
he reached home soon after	త్వరగానే ఇల్లు సమీపించింది
in how many states are you present in the country	మనదేశంలో ఎన్ని రాష్ట్రాలు ఉన్నాయి
she began writing poetry at a young age	ఆమె చిన్న వయస్సులోనే కవిత్వం రాయడం ప్రారంభించింది
thank u everyone	అందరికి ధన్యవాదాలు
petrol prices in rs	పెట్రోల్ ధరలు ప్రతీకాత్మక చిత్రం
a few days ago i was giving lectures around the silicon valley in california	కొన్ని వారాల క్రితం అమెరికాలోని కాలిఫోర్నియాలో ఉండే సిలికాన్ వ్యాలీ ఏరియాలోని పలు ప్రాంతాల్లో నేను ఉపన్యాసాలు ఇస్తూ గడిపాను
later he got married to another woman	తర్వాత మరో అమ్మాయిని పెళ్లి చేసుకున్నాడు
telephone numbers	సెల్ ఫోన్ నంబర్లు
he first won as village sarpanch and later as samithi president and then as a bank chairman	మొదట గ్రామ సర్పంచ్ గా తరువాత సమితి అధ్యక్షుడిగా తరువాత బ్యాంక్ చైర్మన్ గా గెలిచాడు
passengers face a lot of problems	వీళ్లతో ప్రయాణికులు అనేక ఇబ్బందులు పడ్డ సందర్భాలు వున్నాయి
zambia has approximately identified species animal species plant species and bacterial species and other microorganisms	జాంబియా సుమారుగా  జాతులలో  జంతు జాతులు  వృక్ష జాతులు  బాక్టీరియలు సూక్ష్మజీవుల జాతులు ఉన్నాయి
he claimed she was lying	తాను మోసపోయానని వాదించింది
the incident had taken place at karwar in karnataka	ఈ ఘటన ఉత్తర కన్నడ జిల్లాలోని కార్వార్ లో చోటుచేసుకుంది
public transportation was suspended across the city	నగరవ్యాప్తంగా రహదారులపై ప్రజా రవాణా నిలిచిపోయింది
of zerah the family of the zerahites of shaul the family of the shaulites	జెరహీయులు జెరహు వంశస్థులు షావూలీ యులు షావూలు వంశస్థులు
car reviews	వాహనం యొక్క సమీక్షలు
but state did not accept it	అయితే రాష్ట్ర ప్రభుత్వం సహకరించలేదు
in a saucepan add cream milk and sugar and mix well till the sugar dissolves completely	ఒక పాత్రలో పాలు పంచదార కోకో పొడి వేసి స్టౌ మీద ఉంచి పంచదార కరిగేంతవరకు బాగా కలుపుకోవాలి
candidates need to be graduates	అభ్యర్ధులు డిగ్రీ పాస్ కావాల్సి ఉంటుంది
he has married twice	ఆమె రెండుసార్లు వివాహం చేసుకుంది
the fire brigade dept are dousing the flames	గ్నిమాపక సిబ్బంది మంటలను అదుపుచేస్తున్నాఉ
a total of candidates had filed nominations for the bypoll	మరోవైపు ఉప ఎన్నికల్లో నామినేషన్ స్క్రూటిని లో మొత్తం  నామినేషన్స్ స్క్రూటిని చేశారు
special night	ప్రత్యేకమైన రాత్రి
loan recovery	రుణ పునర్నిర్మాణం
the accident occurred when a truck hit the car	కారును ట్రక్కు ఢీకొనడంతో ఈ ప్రమాదం జరిగింది
his mobile phone didnt ring	తని ఫోన్ కలవట్లేదు
why do cats hate baths	ఎందుకు కుక్కలు పిల్లులు నచ్చని
planting and care	సాగు మరియు హార్వెస్టింగ్
enquired about his health condition	వాజపేయి ఆరోగ్య పరిస్థితి అడిగితెలుసుకున్నారు
the tongue is put in the vagina and stimulated	నాలిక యోనిలోనికి చొప్పించి కృత్రిమ సంభోగం కావిస్తాడు
last date for withdrawal of candidature is november	దరఖాస్తులకు చివరితేదీ   నవంబర్
two years previously	రెండు సంవత్సరాల క్రితం
search file types or applications	ఫైలు రకాన్ని లేదా అనువర్తనాలను వెతకండి
telangana has reported coronavirus cases and deaths till date	తెలంగాణలో ఇప్పటి వరకు కరోనా వైరస్  మందికి సోకగా  మంది మృత్యువాత పడ్డారు
the soldiers then took him to a military camp where after he was beaten for four days one of them shot him in the leg	కానీ బైబిలు శిక్షణ పొందిన తన మనస్సాక్షి మూలంగా ఆయన దానిలో చేరేందుకు నిరాకరించాడు
avoid sugar and refined carbohydrates	చక్కెర మరియు శుద్ధి కార్బోహైడ్రేట్లను తగ్గించండి
mamlatdar executive magistrate	మమలత్దార్  ఎగ్జిక్యూటివ్ మేజిస్ట్రేట్
hollywood hangover	హాలీవుడ్ లీక్
stroke or brain attack is the third largest killer after cancer and heart disease	గుండె పోటు క్యాన్సర్ల తర్వాత ప్రాణాలను కబళిస్తున్న మూడో అతి పెద్ద సమస్య పక్షవాతమే
it is a very tasty sweetdish	ఈ చాలా రుచికరమైన వంటకం
why i do it	నిజానికి ఎందుకు చేస్తాను
apple iphone s	యాపిల్ ఐఫోన్ ఎస్
asthma is a chronic disease of the airways	ఆస్త్మా అనేది ఊపిరితిత్తుల వాయు మార్గాల వ్యాధి
bahadur shah zafar had already fled to humayuns tomb	బహదూర్ షా జఫర్ అప్పటికే హుమాయూన్ సమాధికి పారిపోయాడు
and here we look at only the possible ways in which the causes and combine to produce effect	మరియు మనము ఇక్కడ కారణాలు మరియు ప్రభావము కలిపి మిళితం చేస్తే వచ్చే సాధ్యమైన మార్గాలు మాత్రమే చూస్తాము
lakh crores	లక్షల కోట్లకు చేరింది
you discover new friends along the way	ప్రయాణాలలో కొత్త మిత్రులతో పరిచయాలు పెరుగుతాయి
it makes the skin supple and beautiful	ఇది చర్మాన్ని సాప్ట్ గా మరియు బ్రైట్ గా మార్చుతుంది
lay off tata motors cuts up to managerial jobs	టాటా మోటార్స్ ఉద్యోగుల్లో  మంది తొలగింపు
she was working as a teacher in a government school in the kothkai area of shimla district	ఆమె గతంలో చిక్కమగళూరు జిల్లాలో ప్రభుత్వ పాఠశాలలో టీచర్గా ఉద్యోగం చేసేవారు
pacific ocean	పసిఫిక్ కోస్ట్
cost of tickets	టిక్కెట్ ధర
disease burden	వ్యాధి భారం
thank you for making us proud sir	మమ్మల్ని గర్వపడేలా చేసినందుకు ధన్యవాదాలు సింధు అని ట్వీట్ చేశారు
google deletes chinalinked youtube channels for spreading misinformation	సెర్చ్ ఇంజన్ గూగుల్  చైనాలింక్డ్ యూట్యూబ్ ఛానెల్లను తోలగించింది
the meeting was chaired by sarpanch	సర్పంచ్ బత్తుల రమ అధ్యక్షతన జరిగిన సభ జరిగింది
women are being suppressed	మహిళలను అణిచివేతకు గురిచేస్తారు
how is osteoporosis treated	ఆస్కార్రియస్ చికిత్స ఎలా
each district	్రతి జిల్లాలో
regular occurence	రెగ్యులర్ ప్లానా
i mean these things are just coming out of the damn walls	దీనికి పూర్వము తత్వపురి అని పేరుఈ విషయము ఆ గ్రామ శివాలయమ్ మీద ఉన్న్నది
the same happened here	సరిగ్గా ఇక్కడ కూడా అదే జరిగింది
such things keep happening	ఇలాంటి సంఘటనలు జరుగుతూనే ఉన్నాయి
champions trophy pakistan team fined after victory over sri lanka	ఛాంపియన్స్ ట్రోఫీ శ్రీలంకపై ఆస్ట్రేలియా ఘన విజయం
she is detailed and comprehensive	అతను అత్యంత సమగ్ర మరియు వివరణాత్మక ఉంటుంది
focus on achievement	విజయంపై దృష్టి పెట్టండి
at launch gmail had an initial storage capacity offer of one gigabyte per user a significantly higher amount than competitors offered at the time	ప్రారంభించినప్పుడు జీమెయిల్ వినియోగదారుకు ఒక గిగాబైట్ యొక్క ప్రారంభ నిల్వ సామర్థ్యాన్ని కలిగి ఉంది ఆ సమయంలో అందించే పోటీదారుల కంటే ఇది చాలా ఎక్కువ
party leaders organised blood donation camps	పార్టీ నాయకులు రక్తదాన శిబిరాన్ని ఏర్పాటు చేశారు
theres no such thing	అలాంటిదేమీ లేదంటున్నాడు ఆర్య
during the major focus of the programme would be on mass awareness programme for farmers in over lakh villages covering all districts of the country	ఈ కార్యక్రమం కింద  మధ్య దేశంలోని లక్ష గ్రామాల్లో రైతుల కోసం సామూహిక అవగాహన కల్పనపై దృష్టి సారిస్తామని ప్రకటించారు
moreover rs	అంతేకాదు రైతన్నల సంక్షేమం కోసం న్యాయ్ పథకం ద్వారా నెలకు రూ
style and technique	శైలి మరియు టెక్నాలజీ
so its never a good idea to think too much	కాబట్టి ఆలోచించడమనేది ఎప్పటికీ వౌలికమైనదిగా ఉండదు
why is it popular	ఎందుకు సరిగ్గా ఇది ప్రజాదరణ ఉంది
walvis bay	వాల్వీస్ ఖాడీ
bombay shirt co currently has two stores in mumbai one in bengaluru and one in delhi	లాంబోర్గినీ ఇండియాకు ఇప్పటికే ముంబైలో ఒక షోరూమ్ ఢిల్లీలో రెండు షోరూమ్లు ఉన్నాయి
such a fun movie	అంత పకడ్బందీగా ఉందీ సినిమా
good actress	మంచి నటుడు
hes bald	అతను బట్టతల ఉంది
do not overdo your exercises	వ్యాయామం ఎక్కువ చేయొద్దు
suheli par is an island group comprising of suheli valiyakara and suheli cheriyakara two small islets located approximately km south of agatti island	ఆగట్టి ఐలాండ్ కు సుమారు  కి మీ ల దూరంలో సుహేలి వలియాకర మరియు సుహేలి చేరియాకర అనే రెండు చిన్న దీవులు కలసి సుహేలి పార్ అనే దీవి సముదాయాన్ని ఏర్పరచాయి
women are not safe	ఆడవారికి రక్షణ లేకుండా పోతుంది
the railways get rs	రైల్వేకి ఏటా రూ
history culture beauty	సంస్కృతి మతం చరిత్ర
its pure fun	ఈ ఒక స్వచ్ఛమైన సరదాగా ఉంటుంది
the karnataka assembly is member strong	కర్ణాటక అసెంబ్లీలో  మంది సభ్యుల సంఖ్య
the bjp is in serious crisis	రాష్ట్రంలో బీజేపీ తీవ్ర ఒడిదుడుకులు ఎదుర్కొంటోందన్నారు
million	లక్షలు వసూలు చేసింది
most important of all	అన్నింటికంటె అతి ముఖ్యమైన ఆలోచింపతగిన విషయం
the movie is a biographical drama based on the life of jayalalithaa	అమ్మ తలైవి జయలలిత జీవితం ఆధారంగా సినిమాను తెరకెక్కిస్తున్నారు
he told me about their struggles	వాళ్ళ అల్లరి గురించి చెప్పాడు
us travel	అమెరికాలో టూరింగ్
but since she could not change her situation she decided to change her viewpoint	తాను తన పరిస్థితిని మార్చుకోలేదు కనుక తన దృక్కోణాన్ని మార్చుకోవాలని నిర్ణయించుకుంది
if true details are shown	నిజమైతే వివరములను చూపుము
cpi national secretary d raja	సీపీఐ జాతీయ కార్యదర్శి డి రాజా
crore to the state	కోట్లు ప్రభుత్వ ఖజానాకు దఖలు పడ్డాయి
the plans include	ప్రణాళిక క్రింది అంశాలను కలిగి
the incident took place at ntr nagar in kodavalur nellore district	ఈ సంఘటన నెల్లూరు జిల్లా చేజర్ల మండలం ఎనమదలలో చోటు చేసుకుంది
he asked his son	నేరుగా కొడుకును అడిగింది
we didnt think of it	మాకోసం మేమేమీ ఆలోచించలేదు
some like it	అందులో కొన్ని నచ్చాయి
microsd cards up to gb are supported	జీబీ వరకూ మెమొరీ కార్డుని ఉంచొచ్చు
then the government took the decision	దాంతోప్రభుత్వం సంచలన నిర్ణయం తీసుకుంది
command positions	స్థానం ఆదేశాలు
mans hand gets stuck between metro coach door dies	మెట్రో రైలు డోర్ నిండు మనిషి ప్రాణాలు మింగేసింది
ask me	అడగాలి కూడాను
more details about the incident are awaited	ఈ సంఘటనకు సంబంధించి మరిన్ని వివరాలు తెలియాల్సివుంది
it has antibacterial antioxidant antifungal and antiinflammatory properties	ఇందులో యాంటీ యాక్సిడెంట్లు యాంటీ ఏజింగ్ యాంటీ బ్యాక్టీరియల్ యాంటీ వైరల్ యాంటీ ఫంగల్ గుణాలున్నాయి
at times he questions himself	ఒక్కోసారి ఐతిహ్యం కూడా తనని తాను ప్రశ్నించుకుంటుంది
womens rights	ది రియాలిటీ ఆఫ్ ఉమెన్స్ రైట్స్
every other day the king shaved himself	మరువక పత్రి మరువక వృక్షానికి చెందినది
he is not a politician	తాను రాజకీయాలు మాట్లాడనంటున్నారు
onion g	వాల్నట్   గ్రాముల
controversial church	ఘర్షణ చర్చి
statistics speak differently	గణాంకాలు వేరుగా ఉంటాయి
the building was completely gutted	దాంతో భవన నిర్మాణం పూర్తిగా సన్నగిల్లింది
britains world	బ్రిటన్ నుంచి ప్రపంచానికి
security is lax	భద్రతా కరువవుతోంది
miheeka bajaj all decked up for the wedding	పెళ్లి వేడుకకు సిద్దమవుతున్న మిహీకా బజాజ్
he wrote songs for more than films	కి పైగా చిత్రాలకు నేపథ్య సంగీతాన్ని ప్రోగ్రామ్ చేశాడు
i take care of my fitness every day	రోజూ కంపల్సరీ ఫిట్నెస్ మీద శ్రద్ధ పెడతాను
oneplus has overtaken samsung to take the lead in the indian premium smartphone market	ఇండియన్ స్మార్ట్ఫోన్ మార్కెట్లో ప్రీమియం విభాగంలో తనను అగ్రస్థానం నుంచి తోసేసిన వన్ప్లస్ కంపెనీకి శాంసంగ్ అదిరిపోయే పంచ్ ఇచ్చింది
los angeles times	లాస్ ఏంజిల్స్ టైమ్స్
heat up some oil in a pan and stir fry the chicken pieces	ఒక వేయించడానికి పాన్ లో వెన్న వేడి మరియు కొద్దిగా వేయించాలి చికెన్ ముక్కలు
im very happy	నాకు చాలా ఆనందంగా ఉంది అని వ్యాఖ్యానించింది
new delhi bills worth rs	న్యూఢిల్లీ బ్యాంక్లు పెద్ద నోటు రూ
sounds like fun	ఆహ్లాదంగానూ అనిపిస్తుంది
tiger one gunner just got hit	టైగర్ వన్ షికారి జాబు కాకముందు
hyderabad ysrcp chief and leader of opposition ys jagan mohan reddy is walking in the footsteps of his father and late chief mister of united andhra pradesh dr ys rajasekhara reddy	హైదరాబాద్ ముఖ్యమంత్రి పదవిని ఆశిస్తున్న కడప పార్లమెంటు సభ్యుడు వైయస్ జగన్మోహన్ రెడ్డి తన తండ్రి దివంగత కాంగ్రెసు నేత వైయస్ రాజశేఖర రెడ్డి అడుగుజాడల్లో నడుస్తారా
batraha ward no	బాత్రాహా వార్డ్ నెం
each has characteristic symptoms	ప్రతి వ్యాధి నిర్దిష్టమైన లక్షణాలు
but she isnt perturbed	కానీ ఆమె పని భంగం లేదు
richards in their book the privileged planet	రిచర్డ్స్లు ద ప్రివిలేజ్డ్ ప్లానెట్ అనే తమ పుస్తకంలో పేర్కొన్నారు
assistance of voluntary organisations and citizens should be sought for the arrangements	స్వచ్ఛంద సంస్థలు పౌర సమాజాల సహాయ సహకారాలు తీసుకోవాలి
lets take a closer look at some of these key issues	వీటిలో కొన్ని ముఖ్యమైన కేసులను ఒకసారి పరిశీలిద్దాము
congress president rahul gandhi and soni gandhi must apologise for seeking to tarnish hindu religion by coining the saffron terror term alleged bjp spokesperson sambit patra	కాషాయ ఉగ్రవాదం హిందూ ఉగ్రవాదం లాంటి పదాలను ఉపయోగించడంపై కాంగ్రెస్ అధ్యక్షుడు రాహుల్ గాంధీ ఆయన తల్లి సోనియా గాంధీలు క్షమాపణలు చెప్పాలని బీజేపీ అధికార ప్రతినిధి సంబిత్ పాత్రా డిమాండ్ చేశారు
im born and raised in chennai	నేను పుట్టింది పాలకొల్లులో అయినా పెరిగిందంతా చెన్నైలోనే
new regulations	నూతన నియమాల పరిచయం
read here	ఇక్కడ చదవండి
its not difficult to write	దాని గీయడం కష్టం ఏమీ లేదు
in previous elections the jdu and bjp used to fight together	గత ఎన్నికల్లో ఇక్కడ టీడీపీ బీజేపీ జనసేన కలిసి కూటమిగా పోటీకి దిగాయి
how it exactly works	ఇది ఎలా సరిగ్గా పనిచేస్తుంది
in mumbai petrol cost rs	ముంబైలో లీటర్ పెట్రోల్ ధర రూ
if not then it should be dropped	అలా కాకుంటే రిస్ట్కు కట్టుకోవాలి
the bandh was supported by trs and congress parties	టీఆర్ఎస్ రెబల్స్ కు బీజేపీ కాంగ్రెస్ లు మద్దతు ఇస్తున్నాయన్నారు
others are going away abroad	మరికొందరు విదేశాలకు కూడా వెళ్ళాల్సిన పరిస్థితి ఎదురవుతుంది
lets see how	ఎలా చేయాలో చూసేద్దాం మరి
he is doing nothing	ఏ పనీ చేయకుండా ఉంటాడు
results are yet to be declared	ఫలితాలు ఇంకా విడుదల కావాల్సి ఉంది
the house burns down	ఇల్లు తగలడిపోతున్నాయి
repeat for the right leg	ఎడమ పాదం కోసం రిపీట్ చేయండి
churchill brothers back in ileague	ఐ లీగ్లో చర్చిల్ బ్రదర్స్
impact on markets	మార్కెట్లపై ఎఫెక్ట్
he often shares his photos on instagram	ఐతే తన ఫోటోలను మాత్రం ఇంస్టాగ్రామ్ లో పంచుకుంటూ ఉంటుంది
the heavy rainfall on sunday evening left many streets in the city under sheets of water and affected traffic movement	ఆదివారం సాయంత్రం నగరంలోని పలు ప్రాంతాల్లో మోస్తరు నుంచి భారీ వర్షం కురిసింది
alcohol is prohibited	మద్యం నిషేధించడం జరిగింది
thats questionable	అన్నది ప్రశ్నార్థకమే ఏదేమైనా కరుడుగట్టిన సమైక్యావాదైనా
and the second is anxiety	మరియు రెండవ  దుర్బలత్వం
why just politicians	రాజకీయ ప్రత్యర్థుల దాకా ఎందుకు
indian films in pak cinemas	భారత సినిమాలను పాక్లో ఆడనివ్వం
percent of the population speaks the kurmanji dialect of kurdish as their mother tongue	ప్రజలకు  కుర్మంజి  భాషాకుటుంబానికి చెందిన కుర్దిష్ వాడుకభాషగా ఉంది
we are constantly in limbo	మేం నిత్యం భగవరాధనలోనే మునిగి ఉంటాం
approve revision	రివిజన్ ను ఆమోదించు
series leaders	సిరీస్ నాయకులు
research fellowship	రీసెర్చ్ ఫెలోషిప్
the cause of the accident was unknown	ప్రమాదం జరగడానికి గల కారణాలు తెలియరాలేదు
its not difficult to do	సిద్ధం కష్టం వుండదు
rs lakh seized	లక్షలు స్వాధీనం చేసుకున్నారు
union govtreleases rs cr as ii installment of covid financial package to statesuts	రాష్ట్రాలు  కేంద్ర పాలిత ప్రాంతాలకు కోవిడ్ ఆర్ధిక ప్యాకేజీ రెండవ వాయిదా  కోట్ల రూపాయల మేర నిధులు విడుదల చేసిన  కేంద్ర ప్రభుత్వం
how did you romance her	మెను ప్రేమిస్తూనే డేటింగ్ ఎలా చేసావు అంటూ ప్రశ్నించింది
but we arent in the clear yet	అయితే మేము ఇంకా స్పష్టంగా చెప్పలేము
it can irritate eyes throat and lungs	ఇది కళ్ళు గొంతు చర్మానికి చికాకుని కలిగించవచ్చు
the interested farmers would be given subsidy of rs	రైతులకు లబ్ధి చేకూరనుంది
he blew it	ాన్ని తగులబెట్టాడు
the state reported new cases taking the state overall tally to and number of active cases to	రాష్ట్రంలో  కొత్త కేసుల నమోదుతో మొత్తం కేసుల సంఖ్య కు యాక్టివ్ కేసుల సంఖ్య కు చేరాయి
he turns	ఏళ్లు వచ్చినా
are values being undermined	విలువలు పెరుగుతున్నాయా
payment plans	ప్లానింగ్ ఆఫ్ చెల్లింపులు
where are the kids	ఎక్కడి వారీ చిన్నారులు
the pension of rs	వృద్ధాప్య పింఛను మొత్తాన్ని రూ
how to treat	ఎలా వ్యాధి చికిత్స
cant you see anything	ఏదీ కనిపించడంలేదా
soon another crisis unfolded	తాజాగా మరో భయంకరమైన సంక్షోభం కూడా ముందుకు వచ్చింది
and hello	మరి  ఏ క్యా హో రహా హై
recently updated complete themes	ఇటీవల నవీకరించబడిన పూర్తి అలంకారాలు
uninterrupted power supply	నిరంతరాయంగా విద్యుత్ సరఫరా
nobody is our enemy	మాకు లేని ప్రతి ఒక్కరూ శత్రువులు
it smoothens the hair leaving it looking soft shiny and healthy	ఇది షైన్ సాంద్రత మరియు ఆరోగ్యకరమైన చూస్తున్న జుట్టు ఇస్తుంది
you can go later	తర్వాత వెళ్లొచ్చు
passengers too are being inconvenienced	అలాగే ప్రయాణీకులు కూడా నానా అవస్థలు పడుతున్నారు
but i am working on overcoming it	కాని దాన్ని అధిగమించడానికి ప్రయత్నిస్తూనే ఉన్నాను
following is the text of prime ministers message on national handloom day	జాతీయ చేనేత దినం సందర్భం లో ప్రధాన మంత్రి ఇచ్చిన సందేశం యొక్క పాఠం ఈ దిగువ విధం గా ఉంది
but doctors had advised them against it	కానీ వైద్యులు తనొద్దంటూ హెచ్చరించారు
chandrababu meets bjp president rajnath	రాష్ట్రపతితో చంద్రబాబు భేటీ
he later addressed the media persons	తర్వాత ఆయన మీడియాతో మాట్లాడారు
key events	ముఖ్య ఘట్టాలు
theres a variety of films	మీరు చూడగలరు గా వివిధ రకాల సినిమాలు ఉన్నాయి
shortfalls of electricity occur periodically when drought reduces water flow	కరువు నీటి ప్రవాహాన్ని తగ్గితే క్రమానుగతంగా విద్యుత్తు కొరతకు దారితీస్తుంది
the leaders of the two parties are taking jibes at each other	ఇరు పార్టీల నేతలు ఒకరిపై ఒకరు విమర్శలు గుప్పించుకుంటున్నారు
the match between kolkata knight riders and sunrisers hyderabad was a raincurtailed one	కోల్కతా నైట్రైడర్స్ సన్రైజర్స్ హైదరాబాద్ జట్ల మధ్య జరిగిన మ్యాచ్కు మద్యం తాగి వచ్చారు
dinner it should be the lightest meal of the day	డిన్నర్ రాత్రిపూట తేలికైన ఆహారం తీసుకోవాలి
i never believed i was one of them	నేను అలాంటి వారిలో ఒకడిని అవుతానని ఎప్పుడూ అనుకోలేదు
special thanks to the organisers	నిర్వాహకులకు ప్రత్యేక కృతజ్ఞతలు
the working of the	ఆకతాయిల పని
two singles off the first two balls	తొలి రెండు బంతుల్లో రెండు సింగిల్స్ ఇచ్చాడు
forcing helenas twins to come early in attempt to use their genes on himself he is killed by sarah the sisters survived him	డయానా యొక్క ఇద్దరు కుమారులు చర్చికి వెళ్లాలని కోరుకోవడంతో వారి తాతఅమ్మమ్మలు వారిని ఉదయంపూట తీసుకెళ్లారు
has anyone responded	ఎవరైనా రికమెండ్ చేశారా
in our country it is worse	మన దేశంలో మాత్రం పరిస్థితి దారుణంగా తయారైంది
step three	మూడు దశలు
the virus does not affect everybody	వైరస్ ప్రభావం అందరిలోనూ ఒకే మాదిరిగా ఉండదు
subsequently he shifted to hyderabad	అక్కడినుండి హైదరాబాదుకు బదిలీ అయ్యారు
rafi ahmed kidwai nagar scheme	రఫీ అహ్మద్ కిద్వాయ్ నగర్ పథకం
such is our life	మన జీవితాల రోజులు అలాంటివి
coronavirus statewide lockdown to remain in force till may	దేశవ్యాప్తంగా కరోనా వైరస్ వ్యాప్తి చెందకుండా ఉండటానికి మే  వరకు లాక్ డౌన్ జారీ చేశారు
it is at a week low	ఇది  వారాల కనిష్ట స్థాయి
the injured child was handed over to the child welfare committee	బాధితురాలిని చైల్డ్ వెల్ఫేర్ కమిటీకి అప్పగించారు
no sunshine	ఎండ బాధ ఉండదు
educational qualification mbbs	అర్హత ఎంబీబీఎస్ ఉత్తీర్ణత
its not meant for kids	పిల్లలకు తగినది కాదు
in politics anything can happen anytime	రాజకీయాల్లో ఎప్పుడు ఏమైనా జరగొచ్చని నమ్మక తప్పదు
so she starts loving srinivasa rao and decides to marry	కాబట్టి ఇప్పుడామె శ్రీనివాసరావును ప్రేమించడం ప్రారంభించి పెళ్ళి చేసుకోవాలని నిర్ణయించుకుంటుంది
it is all very natural	అత్యంత సహజంగా అన్ని
both had gone to the hotel for a dinner	ఓ హోటల్ కు లంచ్ కోసం వెళ్లిన వీరిద్దరూ మీడియా కంట పడ్డారు
you can even add a little lemon juice to it	దీనికి కొంచెం నిమ్మరసం కూడా కలుపుకోవచ్చు
daily reports	రోజూ నివేదిక
the movie delivers	సినిమా నచ్చి సమర్పిస్తున్నారు
are you a music lover	మీరు సంగీత ప్రియులా
presently rs	ప్రస్తుతం రూ
nobody knows how big the impact could be	ఎవరిపై ఆ ప్రభావం చూపిస్తుందో ఎవరికీ తెలియదు
deciding a strategy	వ్యూహాలు నిర్ణయం
congress supports bharat bandh	భారత్ బంద్కు కాంగ్రెస్ మద్దతు
dhoni is a big big player	ధోనీ అద్భుత ఆటగాడు
currently she has films on hand	ఇప్పటిదాకా  సినిమాలు చేశా
on wednesday december the international cricket council icc announced the full list of its annual awards	ఈ మేరకు బుధవారం డిసెంబర్ న ఐసీసీ అవార్డుల జాబితాను ప్రకటించింది
it is exalted indeed	ఇది నిజమైన ఉన్నత ఉంది
shattered dreams	మునిగిపోయిన కలల
the literature reconstruction was completed when the first novel written by kandukuri veereshalingam was completed	మొట్టమొదటి నవలగా పరిగణించబడుతూన్న కందుకూరి వీరేశలింగం రచన రాజశేఖరచరిత్రము తో తెలుగు సాహిత్యపు పునరుద్ధరణ సంపూర్ణమయ్యింది
world cup	ప్రపంచకప్లు అందించారు
security beefed up in the state	రాష్ట్రంలో శాంతిభద్రతలను పటిష్టం చేశాం
since then indias population has more than doubled	అప్పటి నుంచి అక్కడ భారతదేశానికి చెందిన జనాభా కూడా పెరుగుతూ వచ్చింది
the fire was doused	నిప్పు అంటుకుని మండసాగింది
pray to be as productive and as active in jehovahs service as you can be	యెహోవా సేవను వీలైనంత ఫలవంతంగా ఉత్సాహంగా చేసేలా సహాయం చేయమని ప్రార్థన చేయండి
textbooks featuring new syllabus three pairs of uniform a pair of shoes two pairs of socks a belt notebooks and a schoolbag are being provided as part of the kit	కొత్త సిలబస్తో కూడిన పుస్తకాలు మూడు జతల యూనిఫాం ఒక జత బూట్లు రెండు జతల సాక్స్ బెల్ట్ నోట్బుక్లు స్కూల్బ్యాగ్ వంటి పలు రకాల వస్తువులని కొందరు చిన్నారులకు అందించారు
i found it	ఇది నేను కనుగొన్నాను
producer dil raju	నిర్మాతలు దిల్ రాజు
it boosts your energy to keep you active throughout the day	రోజంతా చురుకుగా పనిచేయడానికి కావల్సినంత సామర్థ్యాన్ని పెంచుతుంది
eligibility for applying	విద్యారుణం దరఖాస్తు
all the other players are new	మిగతా వారంతా యువ ఆటగాళ్లే
who owns the car	కారులో ఉన్న వ్యక్తి ఎవరు
produced by ram charan the surender reddy directorial has nayanathara as the leading lady	సురేందర్ రెడ్డి దర్శకత్వంలో రామ్ చరణ్ నిర్మిస్తున్న ఈ సినిమాలో నయనతార హీరోయిన్
other states too must follow the same	మిగిలిన రాష్ట్రాలు కూడా ఈ దారిలోనే నడవాలి
who launched it	ఎవరు ప్రయోగించారు
another player gets injured	గాయాలబారిన మరో క్రికెటర్
it is directed by rohit shetty	ప్రముఖ దర్శకుడు రోహిత్ శెట్టి దీన్ని రీమేక్ చేస్తున్నాడు
watch out	జాగ్రత్తలివే
nobody has seen it since	అప్పటి నుండి ఇప్పటి వరకూ ఎవరికీ కనబడలేదు
can be used	ను ఉపయోగించుకోవచ్చు
hes the one	అతను అతనే
australia david warner aaron finch captain marnus labuschagne steven smith ashton turner alex carey wk ashton agar pat cummins mitchell starc josh hazlewood adam zampa	ఆస్ట్రేలియా జట్టు  ఆరోన్ పించ్ కెప్టెన్ డేవిడ్ వార్నర్ స్టీవ్ స్మిత్ మార్కస్ స్టోయినిస్ లబ్షేన్ మాక్స్వెల్ అలెక్స్ క్యారీ ప్యాట్ కమిన్స్ స్టార్క్ ఆడం జంసా హెజల్వుడ్
click here for the story	కథనం కోసం ఇక్కడ క్లిక్ చేయండి
cant i be okay	నేను బాగా లేనా
the wages of labourers should be hiked according to the price hike	పెరుగుతున్న ధరలకు అనుగుణంగా కార్మికుల వేతనాలు పెంచాలన్నారు
black white blue orange you can take your pick	నలుపు బూడిద తెలుపు నీలం రంగుల్ని ఎంచుకోవచ్చు
cant you understand	నాంచారమ్మకేమీ అర్థంకాలేదు
crore revenue	కోట్లకు వసూళ్లుతో ప్రభంజనం సృష్టిస్తోంది
arent women equals	వాళ్లింట్లో మహిళలు లేరా
equity investments yield good returns over the long term	ఈక్విటీ ఓరియెంటెడ్ మ్యూచువల్ ఫండ్లు దీర్ఘకాలంలో మంచి రాబడులను అందిస్తాయి
she has reportedly featured in over telugu tamil and hindi movies since	ప్పటివరకు తెలుగు తమిళ భాషలలో చిత్రాలలో కలిపి సుమారు కి పైగా చిత్రాల్లో నటించింది
the diat student team age of ultron which comprised of six members under the guidance of dr	ఆరుగురు విద్యార్థులతో కూడిన డాసునీత ధవళే ఆధ్వర్యంలోని డయట్ బృందం తొలి బహుమతి లక్ష రూపాయలను గెలుచుకుంది
every one has a name	క్కొక్కరు ఒక పేరు పెడతారని అన్నారు
the incident took place in west godavari district	పశ్చిమ గోదావరి జిల్లా తణుకులో ఈ సంఘటన చోటు చేసుకుంది
the accident claimed lives and made several hundred people ill	ఈ ఘటనలో  మంచి చనిపోగా వందల సంఖ్యలో బాధితులు అయ్యారు
great man he is	అంతటి గొప్ప మనిషి ఆయన
crores	కోట్లు సేకరించింది
by gods grace	దేవుడి దయవల్లతోనే
farmers are frustrated over the unpredictability of prices	నిలకడ లేని ధరలతో రైతులు బేజారవుతున్నారు
the opposition captain virat kohli might be playing country cricket in england during the bengaluru test	ఇకపోతే కెప్టెన్ విరాట్ కోహ్లీ స్వదేశంలో ఇంగ్లాండ్ తో జరగనున్న క్రికెట్ మ్యాచ్ లలో ఆడనున్నారు
paul rejoiced to see how god strengthened him	దేవుడు తనను ఎలా బలపరుస్తున్నాడో చూసినప్పుడు పౌలు ఆనందించాడు
the state health	రాష్ట్ర వైద్య ఆరోగ్య శాఖ
thats why it came out so well	అందుకే మంచి ఔట్పుట్ వచ్చింది
i want a job	నాకు జాబ్ చెయ్యాలని వుంది
the information is to be given in two days time	వీటిని రెండు రోజుల్లో పోలీసులకు అందజేయనున్నట్టు సమాచారం
manivasakam file photo	డొక్కా మాణిక్యవరప్రసాద్ఫైల్ ఫోటో
his fit is great	ఆమె కమిట్మెంట్ గొప్పదన్నారు
crore	కోట్ల నికర లాభాన్ని నమోదు చేసింది
rs lakh sought in damages	రూ కోట్లకు పరువు నష్టం దావా వేస్తున్నా
he works very hard	తను బాగా కష్టపడతాడు
mustard half teaspoon	పంచదార  అర టీస్పూన్
her personal life was an unhappy one	ఈమె వ్యక్తిగత జీవితం మాత్రం విషాదమే
new delhi the supreme court on friday referred to its constitution bench the matter pertaining to a ban on the entry of women at keralas historic sabarimala temple	సాక్షి న్యూఢిల్లీ శబరిమల ఆలయ కేసును రాజ్యంగ ధర్మాసనానికి బదిలీ చేస్తూ దేశ అత్యున్నత న్యాయస్థానం శుక్రవారం తీర్పు ఇచ్చింది
never ever	ఎప్పుడూ చేయకపోతే
basic rules	ప్రాథమిక నియమాలు జాబితా
i love france	కానీ ఫ్రాన్స్ అంటే నాకిష్టమే
many got injured	అనేకమంది గాయప డ్డారు
attractive salary	ఆకర్షణీయ వేతనాలు
i do not know exactly	సరిగ్గా తెలీదు ఇష్టం లేదు మరి
these districts are	కౌంటీలు క్రిందివారు
booming market	పుంజుకున్న మార్కెట్
lakhs in cash	లక్షల క్యాష్ రివార్డును ఇవ్వనున్నది
review needed comment	సమీక్షించాలి
sugar tablespoons	షుగర్   టేబుల్ స్పూన్లు
despite its growing market share transbrasil was already experiencing financial problems	స్థిరమైన అభివృద్ధి ఉన్నప్పటికీ బ్రిస్బేన్ యొక్క అభివృద్ధి అవస్థాపన సమస్యల వల్ల పురోగమించలేకపోయింది
rashmika mandanna the super gorgeous heroine has become the most sought after actress in tollywood	టాలీవుడ్ లో స్టార్ హీరోయిన్ గా దూసుకుపోతున్న ముద్దుగుమ్మ రష్మిక మందన
organisations schools	వ్యాపారాలు పాఠశాలలు సంస్థలు
the sky was azure blue	ఆకాశం నారింజ పండు రంగులో కనిపించింది
just for the name	కేవలం పేరు కోసమా
many are dying	ఎంతో మంది అమరులవుతున్నారు
the indian army launched a fierce counteroffensive against the unprovoked firing and retaliated strongly to pakistans aggression	పాక్ దాడులను భారత సైన్యం దీటుగా తిప్పికొట్టడంతో ఇరువైపులా భారీగా కాల్పులు జరిగాయి
three soldiers killed in pakistan bombing	పాక్ కాల్పులు మృత సైనికుడు హైదరాబాద్వాడే
newborn babies should be fed mothers milk	చిన్న పిల్లలకు తల్లి పాలు తప్పనిసరిగా పట్టించాలి
day off	మూన్ డేస్
crores	కోట్లు ఇచ్చినమన్నారు
the movie cost rs	ఆ సినిమాకు రూ
but tong doesnt agree	కాని ఆరోగ్యము సహకరించలేదు
it is situated in balochistan province about km north of karachi	ఇది బెలూచిస్తాన్ రాష్ట్రంలో కరాచీ నుండి  కి
and ye shall keep it a feast unto the lord seven days in the year it shall be a statute for ever in your generations ye shall celebrate it in the seventh month	అట్లు మీరు ఏటేట ఏడు దినములు యెహోవాకు పండుగగా ఆచరింపవలెను ఇది మీ తర తరములలో నిత్యమైన కట్టడ ఏడవ నెలలో దానిని ఆచ రింపవలెను
but its so wrong	అయితే ఆలా చేయటం చాలా తప్పు
did you get it eventually	నీగతి యిట్లా పట్టిందా చివరికి
the governments selfreliance goals for the lca included the three most sophisticated and challenging systems the flybywire fbw flight control system fcs multimode pulsedoppler radar and afterburning turbofan engine	కోసం స్వావలంబన సాధించాల్సిన లక్ష్యాలలో మూడు అత్యంత అధునాతన వ్యవస్థలు ఉన్నాయి ఫ్లైబైవైర్  ఫ్లైట్ కంట్రోల్ సిస్టమ్  మల్టీమోడ్ పల్స్డాప్లర్ రాడార్ ఆఫ్టర్ బర్నరు కలిగిన టర్బోఫాన్ ఇంజిన్
prashant who resides in musapet anjaneyanagar is working in the movie eppatlo ramudila sitala evaru untaarandi babu	మూసాపేట ఆంజనేయనగర్లో నివాసం ఉంటున్న బాలప్రశాంత్  ఇప్పట్లో రాముడిలా  సీతలా ఎవరుంటారండి బాబు సినిమా హీరోగా నటిస్తున్నాడు
china unit	చైనా ఏకాకి
violence never lasts long	దౌర్జన్యం ఎక్కువ కాలం నడవదు
the staff	సిబ్బంది అందిస్తున్న
aerial photography	ఏరియల్ ఫోటోగ్రఫీ
i would again say the same thing	నేను మళ్లీ అదే మాట చెబుతాను
it is shot simultaneously in tamil telugu and hindi	తెలుగు తమిళం హిందీ భాషల్లో ఏకకాలంలో రూపొందడం విశేషం
making change	మార్పు చేస్తున్నాం
not in my mind	మనసులో అనుకోలేదు
click for more details	పూర్తి వివరాల కోసం క్లిక్ చేయండి
yes the law acted as a temporary tutor or guardian leading to christ gal	అవును ధర్మశాస్త్రం కొంతకాలంపాటు వాళ్లను నడిపించే నిర్దేశకునిగా లేదా  బాలశిక్షకునిగా  పనిచేసింది  గల
additional taxes apply	దీనిని అదనపు చార్జీలు వర్తిస్తాయి
fabulous music	అద్భుతమైన సంగీతం
needed	కావాలన్నాడు
fans wait for the match to start	షో ఎప్పుడు ప్రారంభం అవుతుందా అని ఎదురుచూస్తున్నారు అభిమానులు
the countrys stock market swooned	దేశీ స్టాక్ మార్కెట్ చతికిలపడింది
and after ahithophel was jehoiada the son of benaiah and abiathar and the general of the kings army was joab	అహీతోపెలు చనిపోయినమీదట బెనాయా కుమారుడైన యెహోయాదాయును అబ్యా తారును మంత్రులైరి యోవాబు రాజుయొక్క సేనకు అధిపతిగా నియమింపబడెను
keywords being searched	శోధన కీవర్డ్లు
then he gave a rs	అనంతరం తన వద్ద రూ
songs are sung	పాటలు పాడినం
swaminathan committee recommendations	స్వామినాథన్ కమిటీ సిఫార్సులు అమ లుజరపాలి
two children received serious injuries	ఇద్దరు కొడుకులకు తీవ్ర గాయాలయ్యాయి
he had no interest in studies	చదువుపై అస్సలు ఆసక్తి ఉండేది కాదు
the net profit stood at rs crore as against rs	కోట్ల నికర లాభం ఆర్జించింది
the threetime	మూడుసార్లు
its a very good habit	చాల మంచి అలవాటు
it is has another benefit as well	దీనివల్ల ఇంకో వుపయోగమూ వుంది
suitable for everyone	అందరికీ సముచిత
budgetary control	బడ్జెట్ నియంత్రణ
it has antipyretic and antiinflammatory properties	ఇందులో యాంటీ ఇన్ఫ్లమేటరీ మరియు పెయిన్ రిలీఫ్ లక్షణాలు పుష్కలంగా ఉన్నాయి
whats the benefit	ఏం లాభం జరుగుతుంది
candles are either absent or two in number	అవస్కరం ఒకటి లేదా రెండు సంపర్క కంటకాలు ఉంటాయి
and really	మరి నిజంగా
he was seen by some perhaps when he commanded go make disciples	బహుశా ఆయన  మందికి కనిపించినది మీరు వెళ్లి
new delhi warning bells are ringing for the national capital once again	న్యూఢిల్లీ దేశ రాజధాని మరోసారి భగ్గుమంది
he has announced to face the case in the court	ఈ కేసును తాను న్యాయ స్థానంలో ఎదుర్కొంటానంటూ ప్రకటించాడు
at first glance liked it	తొలిచూపులోనే నచ్చాడు
stay positive and enjoy your life	సానుకూలంగా వ్యవహరించటం జీవితాన్ని ఆనందంగా గడపటం అలవాటు చేసుకోవాలి
indeed israel climaxed a long history of rebellion by rejecting jesus at which point jehovah rejected them matthew	అవును యేసును నిరాకరించడం ద్వారా ఇశ్రాయేలు సుదీర్ఘమైన తిరుగుబాటు చరిత్రను ముగింపుకు తీసుకువచ్చింది ఆ సమయంలోనే యెహోవా వారిని తృణీకరించాడు   మత్తయి
congress bjp marches	కదలని కాంగ్రెస్ బీజేపీ
crores each	కోట్లు ఇవ్వాలి
home grown	ఇంట్లోనే పండిస్తం
he posted pictures of the same on twitter	ఆ విషయాన్ని ఆయనే స్వయంగా ఫోటోలతో సహా ట్విట్టర్ లో పెట్టి సంబరపడిపోయారు
indiarussia trade target of us billion dlrs trade by achievable anand sharma	నాటికి భారత్  ఫ్రాన్సు మధ్య  బిలియన్ యూరోల వ్యాపార లక్ష్యం ఏర్పాటు చేసుకున్నట్టు చెప్పారు
trade and investment	వెంచర్ పెట్టుబడి మరియు వెంచర్ వ్యాపార
how the case started	కథ ఎలా మొదలైందంటే
not angry	ోపం కాదమ్మా
she acts in a variety of tv serials	ఆమె పలు సీరియల్స్లో నటించారు
ceramic technology thoothika santosh kumar prakasam district	సిరామిక్ టెక్నాలజీ తూతిక సంతోష్ కుమార్ ప్రకాశం జిల్లా
i dont think about them	అనే విషయాలు నేను ఆలోచించడం లేదు
heaven or hell	శాపం లేదా దీవెన
we gave message of peace to the world	ప్రపంచానికి దేశం శాంతి సందేశాన్ని ఇచ్చిందన్నారు
the last date for application submissions is november	దరఖాస్తు సమర్పణలకు చివరి తేదీ  నవంబర్  ఆసక్తి ఉన్నవారు    ద్వారా దరఖాస్తు చేసుకోవచ్చు
it violates the law	అది చట్టాన్ని ఉల్లంఘించినట్లు అవుతుంది
then he gave a rs	ఆపై అతినికి ఇవ్వాల్సిన రూ
jehovah has beautified his people in another way	యెహోవా తన ప్రజలను మరో రీతిలో కూడా శృంగారించాడు
ratnavel pandian j	ఎస్రత్నావెల్ పాండియన్ జె
the lungs are the worst affected by smoking	పొగాకు కారణంగా అత్యంత ఎక్కువగా దెబ్బతినేది ఊపిరితిత్తులే
its a new ball wicket	ఇది కొత్త వికెట్
crores	కోట్లకు పైగా వసూళ్లు సాధించింది
popular destinations	ప్రసిద్ధ స్థలాలు
she is a heroine	అంటోంది ఈ హీరోయిన్
home dont miss ed files fresh money laundering case against jet airways naresh goyal	జాతీయం  జెట్ ఎయిర్వేస్ వ్యవస్థాపకుడు నరేష్ గోయల్ పై ఈడీ కేసు నమోదు
if all goes	అన్ని సక్రమంగా ఉన్నా
mumbai profit booking negative global cues and a weakened rupee depressed the indian equity markets on tuesday	ముంబై అంతర్జాతీయ మార్కెట్ల ప్రతికూల సంకేతాలు దేశీయ పరిణామాల నేపథ్యంలో స్టాక్ మార్కెట్లు నష్టాలతో మొదలయ్యాయి
he was rushed to a nearby hospital where he was declared brought dead	అనంతరం కరేన్ను దగ్గర్లో ఉన్న ఆసుపత్రికి తరలించారు
the nature is beautiful here	ఇక్కడ ప్రకృతి రమణీ యంగా ఉంటుంది
he joined the bjp recently	తాజాగా ఆయన మళ్లీ బీజేపీ గూటికి చేరారు
after the formation of the telangana state the government had declared bonalu as a state festival	తెలంగాణ ప్రత్యేక రాష్ట్రం ఏర్పడిన తరువాత బోనాలను రాష్ట్ర పండుగగా నిర్వహిస్తున్నారు
engineering construction	ఇంజనీరింగ్ మరియు నిర్మాణం
thats the hope	ఇది ఆశలు
the operation was conducted successfully	ఆపరేషన్ సజావుగా జరిగింది
isro has taken another step forward into space	అంతరిక్ష ప్రయోగాల్లో ప్రత్యేకతను చాటుకుంటున్న ఇస్రో మరో మైలురాయికి చేరువ అవుతోంది
lakh	కోట్లు
the bus rammed into the road divider	బస్సు ప్రమాదంలో వాడ్ని పొట్టనబెట్టుకుంది
american writer mark twain called the cherimoya the most delicious fruit known to men	ప్రముఖ అమెరికన్ రచయిత మార్క్ ట్వెయిన్ హనుమంత ఫలాన్ని మానవుడికి తెలిసియున్న ఫలాల్లో అత్యంత రుచికరమైనది  అని అభివర్ణించాడు
the second season did get a bit heavy on me	సెకండ్ సీజన్ నానికి కాస్త ఇబ్బందిగానే మారింది
bjps loss	బీజేపీ ఘోర పరాజయం
additional services	అదనపు సేవలకు రుసుము
she did not agree	అంతుకు ఆమె ఒప్పుకోలేదు
the movie starts off slowly	ఆ సినిమా చాలా స్లోగా రన్ అవుతుంటుంది
it has to be bought separately	ఇది విడిగా కొనుగోలు ఉంటుంది
couldnt get out of bed	మంచం మీద నుంచి లేవడంలేదుట
i liked it very much	నాకు చాలా బాగా నచ్చింది
the government rejected the offer	సంస్థ ఆఫర్ను రిజెక్ట్ చేసింది
the doctors are saying she is recovering	వారు కోలుకుంటున్నట్లు తెలిపారు డాక్టర్లు
problem solved right	ప్రాబ్లమ్ సాల్వ్ అయినట్లే కదా
doctors are shocked	దీంతో సదరు వైద్యులు షాక్ అయ్యారు
more education	మరింత విద్య
the king frowned	రాజు బిక్కమొహం వేశాడు
worlds largest cricket stadium is coming up in ahmedabad	అహ్మదాబాద్లో అతిపెద్ద క్రికెట్ స్టేడియం
drug abuse in bollywood	బాలీవుడ్లో డ్రగ్స్ నీలినీడలు
not pooja	జూటా కాదు
the freshwater should only be used for drinking purposes	మంచినీటిని తాగునీటి అవసరాలకు మాత్రమే వాడాలని డీశాలినేషన్ సముద్రం జలాల శుద్ధి చేసిన నీటినే పరిశ్రమలకు వినియోగించాలని స్పష్టం చేశారు
he won the academy award for his performance	వీరి త్యాగమయి నాటకానికి అకాడమీ బహుమతి లభించింది
pick the right one	సరిగ్గా ఎంచుకోండి
actually impossible	అసలు కుదరదు
rs to rs	కోట్ల నుంచి రూ కోట్లు అవుతుందట అమరావతిలో రూ
however at rs	అయితే దీన్ని రూ
bjps undoing in karnataka	కర్నాటకలో బీజేపీకి చెంపదెబ్బ
unable to get notification for preferences	అభీష్టాల కొరకు తాఖీదు ఇచ్చుటను పొందలేము
_new window	కొత్త విండో
however few actually use them	అయితే ఇప్పటివరకు దీన్ని చాలా తక్కువ మంది ఉపయోగించుకున్నారు
meters of land	భూమి యొక్క మీటర్లు
click on the playable image below for the video	లైవ్ కోసం కింద ఇచ్చిన వీడియోపై క్లిక్ చేయండి
travellers are recommended to visit nanjangud bridge on their trip to nanjangud	నంజన్ గూడ్ పర్యాటకులు పరశురామ క్షేత్రాన్ని కూడా తప్పక చూడాలి
already rs	ఇప్పటికే నెలావారీగా మూడు నెలలకోసారి చేసుకుంటున్న రూ
rrr stars jr ntr and ram charan in lead roles	ప్రధాన పాత్రల్లో రామ్ చరణ్ ఎన్టీఆర్
surfactants can be added to the sodium hydroxide solution in order to stabilize dissolved substances and thus prevent redeposition	కరిగిన పదార్థాలను స్థిరీకరించడానికి తిరిగి నిక్షేపమును నివారించడానికి సోడియం హైడ్రాక్సైడ్ ద్రావణంలో సర్ఫాక్టెంట్లను చేర్చవచ్చు
her uncle rajesh died on the spot in the accident	ఈ ప్రమాదంలో రమ్య బాబాయి రాజేష్ అక్కడికక్కడే మృతి చెందారు
uttarkashi bus accident killed after bus falls into bhagirathi river	ప్రయాణికులతో ఉత్తర కాశీ నుంచి గంగోత్రి వెళ్తున్న బస్సు ప్రమాదవశాత్తూ భగీరథి నదిలో పడింది
rupee depreciation and a spurt in international gold prices triggered surge in domestic gold price	రూపాయి క్షీణత ముడిచమురు ధర పెరగడంతో దేశీయ మార్కెట్లో బంగారం ధర అమాంతం దూసుకెళ్లింది
the modi government is pushing the agenda of commercialisation of education	మోడీ ప్రభుత్వం విద్యను కాషాయికరించడం ఆందోళనకరమన్నారు
khashoggi was murdered on october in the saudi consulate in istanbul	ఇస్తాంబుల్లోని సౌదీ అరేబియా దౌత్య కార్యాలయంలో అక్టోబర్ న ఖషోగ్గి హత్యకు గురైన సంగతి తెలిసిందే
crores	కోట్లకు చేరిందని ప్రశంసించారు
banking financial services and insurance bfsi	ప్రధానంగా బ్యాంకింగ్ ఫైనాన్షియల్ ఇన్సూరెన్స్ సేవలబీఎఫ్ఎస్ఐ
terrorism is the enemy of humankind	తీవ్రవాదం మానవాళికి శత్రువు అని అన్నారు
google is planning to overhaul the design of gmail for web	జీమెయిల్ కు కొత్త వెబ్ డిజైన్ ను తీసుకువచ్చే పనిలో ఉంది గూగుల్ సంస్థ
at last she won her battle	చివరికి ఆ పోరాటంలో ఆమెనే గెలిచింది
umesh yadav took two wickets	మరో ఎండ్ లో ఉమేశ్ యాదవ్ రెండు కీలక వికెట్లు తీశాడు
telugu is the main language spoken here	ఇక్కడ అత్యధికంగా మాట్లాడే మైనారిటీ భాష తెలుగు
here it is happening	ఇదిగో ఇలా తెరకెక్కబోతోంది
manmadhudu review	మన్మధుడు  రివ్యూ అండ్ రేటింగ్
asia badminton championships hs prannoy saina nehwal went down in semifinals in wuhan	హైదరాబాద్ ప్రతిష్టాత్మక ఆసియా బ్యాడ్మింటన్ చాంపియన్షిప్ ఏబీసీలో సైనా నెహ్వాల్ హెచ్ఎస్ ప్రణయ్ సెమీఫైనల్లోకి దూసుకెళ్లి
the dream was not easy to realize	ఆ కల కూడా అంత తేలిగ్గా తీరలేదు
rs crores	కోట్ల రూపాయలను అందజేశారు
r madhavan and anushka shettys nishabdham is directed by hemanth madhukar	అనుష్క మాధవన్ లీడ్రోల్స్లో దర్శకుడు హేమంత్ మధుకర్ తెరకెక్కించిన చిత్రం నిశ్శబ్ధం
transmission options include a speed manual and automatic transmissions	స్పీడ్ మ్యాన్యువల్ మరియు ఆప్షనల్ ఆటోమేటిక్ ట్రాన్స్మిషన్ గేర్బాక్స్ లతో వీటిని ఎంచుకోవచ్చు
the first rs	ఉత్తమంగా నిలిచిన మొదటి బతుకమ్మకు రూ
georgias main imports are fuels vehicles machinery and parts grain and other foods pharmaceuticals	జార్జియా ప్రధాన దిగుమతులలో ఇంధనాలు వాహనాలు యంత్రాలు యంత్ర భాగాలు ధాన్యం ఇతర ఆహారాలు ఔషధాలు ఉన్నాయి
we dont know	మాకేమీ తెలియనివ్వలేదు
she is followed by priyanka chopra and deepika padukone	వారే దీఇక పదుకొనే మరియు ప్రియాంక చోప్రా
the house is very old	ఆ ఇల్లు చాలా మోడరన్గా వుంటుంది
tearing them	ారిని బోల్తా కొట్టిస్తూ
he has a son and a daughter	కుమార్తె కుమారుడు ఈయనకు సంతానం
hatred and love	లవ్ మరియు నిరాశ
it is sung beautifully by vishal dadlani and shalmali kholgade	ఇది శల్మాళి ఖోల్గడే మరియు విశాల్ దాడ్లని పాడింది
literally the most misused word in the language has officially changed definition	సాహిత్యపరంగా భాషలో అత్యధిక దుర్వినియోగ పదం అధికారికంగా నిర్వచనం మార్చబడింది
repeat if necessary	అవసరమైతే ముట్టడి పునరావృతమవుతుంది
symptoms of the virus	వైరస్ లక్షణాలు ఇవే
command directive	కమాండ్  ఆదేశం
how do i convince her	ఆమెను ఎలా ఒప్పించాలి
doctor killed in road mishap	అనంతపూర్లో రోడ్డు ప్రమాదంలో వైద్యుడి మృతి
greater good	మహామేరు మహా మేలు
a garden further adds to the beauty of the place and attracts the tourists	ఈ టెంపుల్ అందాలు స్థానికులనే కాక పర్యాటకులను సైతం మరల మరల వచ్చేట్లు చేస్తాయి
the incident took place at west venkatapuram hyderabad	ఈ ఘటన భద్రాద్రి కొత్తగూడెం జిల్లాలో చోటుచేసుకుంది
amaravati farmers protest	కొనసాగుతోన్న అమరావతి రైతుల దీక్షలు
she holds a trident in the right side and a lotus in the left	ఈమె కుడి చేతిలో త్రిశూలం ఎడమచేతిలో కమలం ధరించి ఉంటుంది
his identity may befuddle the world in general but it is no mystery to us who was the most important person ever born in bethlehem	బేత్లెహేములో ఇంతవరకు జన్మించిన వారిలోకెల్లా అత్యంత ప్రముఖుడైన వ్యక్తి ఎవరు
he was very simple	అతను చాలా సాదాసీదాగా ఉన్నాడు
how did daniel describe jehovahs spirit domain	సర్వాధిపతిగా పరిపాలించేందుకు ఒక పరిపాలకునికి పరిపాలించబడే ప్రజలుండాలి
courtesy the late show host stephen colbert	టాక్ షో హోస్ట్ స్టీఫెన్ కోల్బెర్ట్
it was crore	కోట్ల భారం పడిందని అన్నారు
the ball goes to the fence quickly	బంతి పిచ్కు తాకగానే వేగంగా దూసుకొస్తోంది
supreme court chief justice ranjan gogoi	వీటిని సుప్రీం కోర్టు చీఫ్ జస్టిస్ రంజన్ గొగోయ్ విచారణ చేశారు
karachi the pakistan cricket board pcb is keen on appointing former captain misbahulhaq as head coachcumchief selector of the national team	కరాచి పాకిస్థాన్ మాజీ సారథి మిస్బా ఉల్ హక్ను పాక్ జట్టు కోచ్గా చీఫ్ సెలక్టర్గా నియమించడానికి పాకిస్థాన్ క్రికెట్ బోర్డు పీసీబీ ఆసక్తి చూపిస్తున్నట్లు సమాచారం
people killed	మంది మృతి
end of over	తో ముగియనుంది
thanks once again	మరొక్కసారి ధన్యవాదములు
it was approved by parliament	దీనికి లోకసభ ఆమోదం తెలిపింది
on flipkart	ఫ్లిప్కార్ట్లో
griefstricken family members of the deceased	ఆమరణ నిరాహార దీక్షకు దిగిన బాధిత కుటుంబ సభ్యులు
the decision was taken by the cabinet	కేబినెట్లో మాత్రం నిర్ణయం తీసుకున్నారు
goalkeepers koen casteels wolfsburg thibaut courtois chelsea simon mignolet liverpool	గోల్కీపర్స్ కోయెన్ కాస్టేల్స్ వూల్ఫ్స్బర్గ్ థిబౌట్ కోర్టోయిస్ చెల్సియా సైమన్ మిగ్నోట్ లివర్పూల్
tarnished golden dreams	ప్రాణాలు తీసిన బంగారు కలలు
literary debate	సాహిత్యం చర్చ
are you a child	యెంతైనా కొడుకు కదా
after three months we set sail in a ship of alexandria which had wintered in the island whose sign was the twin brothers	మూడు నెలలైన తరువాత ఆ ద్వీపమందు శీతకాల మంతయు గడపిన అశ్వినీ చిహ్నముగల అలెక్సంద్రియ పట్టణపు ఓడ ఎక్కి బయలుదేరి
expect an addition of approximately rs	ఫియట్ అవెంచురా దాదాపుగా రూ
simone says people in the field are friendly and curious many are interested	చాలామంది సత్యంపట్ల ఆసక్తి చూపించారు
yall k	ైల్ కె
very pretty to look at	చూడటానికి చాలా అందంగా ఉంది
the law is as under	ఈ క్రింది విధంగా చట్టం మద్దతిస్తుంది
malayappa swamy on kalpavruksha chariot	సర్వ భూపాల వాహనంపై మలయ్యప్ప స్వామి
dollar notes file photo	డాలర్స్ ఫైల్ ఫొటో
doesnt seem like it	ది నచ్చడం లేనట్లుగా ఉంది
in several countries where regulations are in place alternative forms of therapies are gaining acceptance in the conventional medical community and are offered by medical doctors	చికిత్సా విధానాలు క్రమబద్ధం చేయబడిన అనేక దేశాల్లో ప్రత్యామ్నాయ చికిత్సా విధానాలు సాంప్రదాయ వైద్య సమాజపు ఆమోదాన్ని పొందుతున్నాయి వైద్యులు వాటిని అందిస్తున్నారు
these cause a number of diseases	ఇవి అనేక రకాలైన ఇన్ఫెక్షన్లకు దారితీస్తున్నాయి
incidentally the accused is a relative of the victim	నిందితుడు బాధితురాలికి బంధువే కావడం గమనార్హం
the mg hector is available in both petrol and diesel engines	ఎంజీ హెక్టార్ ఎస్యూవీ పెట్రోల్ మరియు డీజల్ ఇంజన్ ఆప్షన్లలో లభ్యమవుతోంది
pawan kalyans tour hits a roadblock	పవన్ కళ్యాణ్ పర్యటన అంతా గప్చుప్గా
experience matters too	అనుభవం కూడా పరిగణనలోకి తీసుకుంటారు
politics has changed	రాజకీయాలు మారుతున్నాయి
it provides moisture to the skin	చర్మానికి చల్లదనాన్ని అందిస్తుంది
water available places change according to the geographical conditions	నీరు లభించే ప్రదేశాలు భౌగోళిక పరిస్థితులను బట్టి మారుతుంది
i was transferred to another station	నాకు పదోన్నతిపై వేరే ఊరు బదిలీ అయ్యింది
but in politics	కానీ సామాజికంగా కానీ రాజకీయాల్లో కానీ
thereby he	దీంతో అతని
give enough time to each subject	అన్ని సబ్జెక్టులకూ తగినంత సమయం కేటాయించాలి
norway and switzerland declare their neutrality	డిసెంబర్  ఇజ్రాయెల్ మరియు వాటికన్లు దౌత్యసంబంధాలు ప్రారంభించాయి
crore	కోట్లు
crore	కోట్ల టర్నోవర్ నమోదు చేసింది
he is reportedly set to join the bjp	ఆయన బీజేపీలో చేరనున్నారనే ప్రచారం జరుగుతోంది
ministry of power ntpc achieves highest daily gross generation of mu as per a statement by ntpc ltd a psu under ministry of power and countrys largest power generation company it has achieved highest daily gross generation of million unit mu on th july	విద్యుత్తు మంత్రిత్వ శాఖ రికార్డు స్థాయిలో  మిలియన్ యూనిట్ల రోజువారీ ఉత్పత్తిని సాధించిన ఎన్టీపీసీ దేశంలోనే అతి పెద్ద విద్యుత్ ఉత్పత్తి సంస్థ అయిన నేషనల్ థర్మల్ పవర్ కార్పొరేషన్ మరో ఘనతను సాధించింది ఆ సంస్థ ప్రకటన ప్రకారం  మిలియన్ యూనిట్ల రోజువారీ ఉత్పత్తితో రికార్డు సృష్టించింది
diego costa scored the solitary goal of the match to maintain chelseas winning streak in the english premier league	మిడిల్స్ బ్రౌగ్పై జరిగిన మ్యాచ్లో డియాగో కోస్టా చేసిన సింగిల్ గోల్ తో చెల్సియా ఈ రికార్డు నెలకొల్పింది
girl student commits suicide	దొంగ అన్నారని విద్యార్థిని ఆత్మహత్య
again why	మరెందుకు
hold for counts and repeat	రెప్స్ కోసం ప్రారంభించి రిపీట్ చేయండి
whats the use	ఉపయోగం ఏమిటీ
the many lurking viruses	ఎన్నో వైరస్లు
when was it registered	వేటిలో రిజిస్టర్ అయ్యారు
actress amyra dastur was the showstopper	అమైరా దస్తుర్ హీరోయిన్గా నటించింది
so its hard to know	అందువల్ల దీన్ని గుర్తించటం కష్టం
again its a matter of personal choice	కానీ మళ్ళీ ఇది వ్యక్తిగత ఎంపిక యొక్క విషయం
is free	ఫ్రీగా ఉంటుంది
the distance is km	కిలో మీటర్ల దూరంలో
gold rush in the indian homes	భారతీయుల ఇళ్లలో బంగారాన్ని దోచుకుంటున్నారు
launched farmers movement	వ్యవసాయ కూలీల ఉద్యమం నిర్మించాడు
then t	అప్పుడు ముక్కంటి
in noida petrol price rose to rs while diesel price was hiked by paise to rs per litre	పైసలు ముంబైలో పెట్రోల్ ధర రూ
the flow of rest is concealed	మిగిలినవి అంతర్వాహిని లు
another amount of rs	ఇతర గ్రాంట్ల రూపంలో మరో రూ
our business and industry play an important role in intrabrics ties	బ్రిక్స్ దేశాల సంబంధాల్లో మన వాణి జ్యం పారిశ్రామిక రంగం ప్రముఖ పాత్ర పోషిస్తాయి
no review	సమీక్ష లేకుండా నిర్ణయాలా
wishing you good health	ఆయురారోగ్య ఐశ్వ ర్యాలనిమ్మని వేడుకుందాం
it offers gb ram and gb storage	జీబీ వరకు ర్యామ్  జీబీ వరకు స్టోరేజ్ ఇందులో కూడా ఉన్నాయి
the workers demanded the state government to send them back to their native places	తమను సొంతూళ్లకు పంపాలని వలస కూలీలు ప్రభుత్వాన్ని వేడుకుంటున్నారు
pm announces setting up of task force to prepare action plan for the next three olympic games and	ఒలింపిక్స్ గేమ్స్ కార్యాచరణ రూపకల్పనకు టాస్క్ ఫోర్స్  ప్రధాని ప్రకటన
it surveys	ఐటి సోదాలు
through the intervening valleys the rivers flow down over ledges of granite or quartz	మధ్యలో ఉన్న లోయలలో గ్రానైట్ క్వార్టేజ్ శిలల మీదుగా నదీప్రవాహాలు సాగుతున్నాయి
and who wins	మరి విజయం ఎవరిని వరిస్తుందో
women only own less than of the world property	ప్రపంచ దేశాధినేతలలో మహిళలు శాతం కంటే తక్కువ సంఖ్యలో ఉంటున్నారు
how to reach the waterfall	హిడ్లుమనే జలపాతం ఎలా చేరుకోవాలి
we welcome the decision	ఈ నిర్ణయాన్ని స్వాగతిస్తున్నాం
apollo	అపోలో  చిత్రం
why because the editors know the language	ఎందుకంటే ఆ సంపాదకులకు తెలుగు చదవడంవచ్చు
montgomery field	మోన్టగోమరీ ఫీల్డ్
main accused of pranati murder case nabbed	ప్రణయ్ హత్య కేసులో నిందితుల అరెస్ట్
an official announcement was made recently	కొద్దిసేపటి క్రితం అధికారిక ప్రకటన విడుదల చేశారు
common symptoms	వ్యాధి మహత్తర లక్షణాలు
she made the remarks in the lok sabha during a debate on the union budget	కేంద్ర బడ్జెట్ పై లోక్ సభలో జరిగిన చర్చలో కవిత మాట్లాడారు
ranji trophy dhruv shorey named delhi captain nitish rana deputy for first two games	రంజీ ట్రోఫీ ఢిల్లీ జట్టు కెప్టెన్గా ధ్రువ్ షోరే డిప్యూటీగా నితీష్ రాణా
he accused the government of misleading the people on the issue	ప్రభుత్వంపై ప్రజల్లో దుష్ర్ఫచారం చేస్తున్నారని ఆరోపించారు
electric plane	ఎలక్ట్రిక్ విమానాలు
out of the cases scrutinised by it the sit by its own account reopened investigation in only	సిట్ ఇప్పటి వరకు  కేసులను పరిశీలించి అందులో కేవలం  కేసులను తిరిగి ప్రారంభించింది
director surender reddy	ఛాయాగ్రహణం సురేందర్ రెడ్డి
based on real events	వాస్తవ ఘటనల ఆధారంగా తీశాం
buildings and cranes	భవనాలు మరియు కంచెల ఉనికి
the main features of new policy regime are revenue sharing contract single licence for exploration and production of conventional as well as unconventional hydrocarbon resources marketing pricing freedom etc	నూతన విధానం ముఖ్యాంశాలలో రాబడి పంపకం కాంట్రాక్టు సంప్రదాయ మరియు సంప్రదాయేతర హైడ్రోకార్బన్ వనరుల అన్వేషణకు ఉత్పత్తికి ఒకటే లైసెన్సు మార్కెటింగ్ పరంగాను ధరల నిర్ణయం పరంగాను స్వేచ్ఛల వంటివి ముఖ్యమైనవి
the details of total loans sanctioned and disbursed by public private sector banks are	ప్రభుత్వ ప్రైవేటు రంగ బ్యాంకులు మంజూరు చేసిన మొత్తం రుణాల వివరాలు
cultural ties	సాంస్కృతిక సంబంధాలు
firefighters are at the spot trying to douse the fire	సంఘటనా స్థలానికి చేరుకున్న అగ్నిమాపక సిబ్బంది మంటలను అదుపులోకి తెచ్చేందుకు ప్రయత్నిస్తున్నారు
crores	కోట్ల ఆదాయం వస్తుంది
the company has recently	తాజాగా ఈ సంస్థ స్మార్ట్ఫోన్లోని
the next step is forward	తదుపరి దశ ముఖం
did he feel tired	అతను అలసిపోయానా
aamir khan plays the role of ameer ali the main character of the novel	ఈ మూవీలో హీరో ఆమిర్ ఖాన్ కాగా బిగ్ బీది ఓ కీలక పాత్ర
still unsolved	ఇప్పటికీ పరిష్కారం కాలేదు
types of heart disease	హృదయ కండరముల వాపు రకాలు
here are the latest rates	ేటెస్ట్ రేట్లు ఇవే
while rajani and madhukar died on the spot suresh died while undergoing treatment in a hospital	ఈ ప్రమాదంలో రజనీకాంత్ మధుకర్ అక్కడికక్కడే చనిపోగా సురేష్ని ఆస్పత్రికి తీసుకెళ్తుండగా ప్రాణాలు విడిచాడు
photos layout	ఛాయాచిత్రముల నమూనా
driving the car	కారు డ్రైవ్ చేయటం
he screamed for help	దీంతో సహాయం కోసం గట్టిగా అరిచారు
modi met a number of sadhus and saints during his stay in the himalayas	హిమాలయాలలో అనేక మంది సాధువులను మోడీ కలిసారు
the design is fantastic	దీని రూపకల్పనే ఒక అద్భుతం
chandrababu has duped the farmers in the name of crop loan waiver	రుణమాఫీ పేరుతో రైతులను చంద్రబాబు ముంచేశారన్నారు
its clear	అంటూ స్పష్టం చేశారు
all quiet	అంతా ప్రశాంతం
the name should be new	టైటిల్ కొత్తగా ఉండాలి
petrol price cut by paise	పైసలు తగ్గిన పెట్రోల్ ధర అర్థరాత్రి నుంచి అమలు
dark patches on skin	చర్మముమీది నల్లని మచ్చలు
new in s content blocking	లో కొత్తగా విషయ నిరోధం
he has fastest century by an indian cricketer in odis in balls	రికార్డ్ ఫాస్టెస్ట్ సెంచరీ సాధించిన ఇండియాకు చెందిన ప్లేయర్ బాల్స్లో
ever since the fans of the movie are eagerly waiting for kgf updates	కేజీఎఫ్ గా రాబోతున్న ఈ సినిమా అప్డేట్స్ కోసం అన్ని భాషల సినిమా అభిమానులు చాలా ఆసక్తిగా ఎదురుచూస్తున్నారు
customers looking for deliveries after september can still book the motorcycles at the authorised jawa motorcycle dealerships check out the differences between the two jawa motorcycles here	సెప్టెంబరు తర్వాత డెలివరీ కోసం చూస్తున్న వినియోగదారులు అధికారం కలిగిన జావా మోటార్ సైకిల్ డీలర్షిప్లలో మోటార్ సైకిళ్లను బుక్ చేసుకోవచ్చు
velu nachiyar was the princess of ramanathapuram and the only child of king chellamuthu vijayaragunatha sethupathy and queen sakandhimuthathal of the ramnad kingdom	ఈమె రామనాడు రాజ్యాన్ని పరిపాలించిన రాజా చెల్లముత్తు విజయరఘునాథ సేతుపతి  రాణి సాకందిముత్తల్ ల ఏకైక పుత్రిక
judgement reserved	తీర్పు రిజర్వ్ చేసింది
people concerned about rising corona cases	కరోనా కేసులు పెరుగుతుండటంతో ఆందోళన
i take chances as an actor	నటుడిగా నన్ను నేను ప్రూవ్ చేసుకుంటాను అన్నారు
once it has cooled keep in refrigerator	డిష్ డౌన్ శీతలీకరణ తరువాత అది రిఫ్రిజిరేటర్ లో పెట్టబడింది
crore	కోట్లకు చేరాయి
ransom magnifies gods righteousness	సిడిరొపౌలస్
people make mistakes	ప్రజలు తప్పులు చేస్తారు
it is fascinating to watch the totonac indians do the delicate work of pollinating the flowers	వారు ప్రతి గుత్తిలో కేవలం కొన్ని పుష్పాలలో మాత్రమే పుప్పొడిని చల్లుతారు
he spoke to the officials and inquired about the incident	అధికారులతో మాట్లాడి ఇన్ఫ్లో వివరాలు అడిగి తెలుసుకున్నారు
likewise without partaking of spiritual food we weaken and die spiritually	అదేవిధంగా ఆధ్యాత్మిక ఆహారం భుజించకపోతే మనం బలహీనపడి ఆధ్యాత్మికంగా చనిపోతాము
nobody spoke for quite a while	చాలా కాలం వరకు ఈ విషయమై ఎవరికీ కూడ చెప్పలేదు
arts aces	ఆర్ట్ ఆర్కైవ్స్
are you crazy	పిచ్చోళ్లమా
but the apex court did not dismiss the appeal	అంతేకానీ తాము వేసిన పిటిషన్ను సుప్రీంకోర్టు కొట్టివేయలేదని వ్యాఖ్యానించారు
love is the most beautiful feeling in the world	ప్రేమ ప్రపంచంలోనే ఓ గొప్ప అనుభూతి
culture and arts	సంస్కృతి కళలకు పుట్టినిల్లు
however the government has not responded	అయినా తమిళనాడు ప్రభుత్వం సమాధానం ఇవ్వలేదు
do regular exercises like stretching walking and swimming	నడవటం జాగింగ్ స్కిప్పింగ్ మొదలైన వ్యాయామాలు చేయాలి
the psychological thriller insomnia starring al pacino and robin williams was shot in canada but was set in alaska	అలాస్కాలో ఉడి కెనడాలోచిత్రీకరించబడిన చిత్రం ఆల్ పసినో రాబిన్ విలియమ్స్ నటించిన ఫిజికలాజికల్ థ్రిల్లర్ చిత్రం ఇన్సోమేనియా
the main symptom of a respiratory illness is coughing	దగ్గు అనేది శ్వాసకోశ వ్యాధుల యొక్క అత్యంత సాధారణ అభివ్యక్తి
he didnt mind though	అయినా అతడు పెద్దగా పట్టించుకోలేదు
the rear setup of the phone gets four cameras	ఫోన్ వెనక నాలుగు కెమెరాల సెటప్ ఉంది
cow seed rs	ఆవు పేడ ముద్ద ఒక్కొక్కటీ రూ
investment and loans	పెట్టుబడులు రుణాలు తీసుకోవడం
no compromise would be done on quality part	నాణ్యత విషయంలో ఎక్కడ కూడా రాజీపడేది లేదన్నారు
but if not then its just not to be	కానీ ఈ సాధ్యం కాదు ఉంటే నైరాశ్యం లేదు
mode of the examination computer based test cbt	పరీక్ష విధానం ఆన్లైన్ కంప్యూటర్ బేస్డ్ టెస్ట్
music is given by devi sri prasad and the cinematography is done by r rathnavelu	రత్నవేలు ఛాయాగ్రహణం దేవిశ్రీ ప్రసాద్ సంగీతం అందిస్తున్నారు
superb movie	రూటుమార్చిన సినిమా
in telangana too the bjp lost four of its five seats	తెలంగాణ ఎన్నికల్లో ఐదు సీట్ల నుంచి నాలుగు సీట్లకు బీజేపీ దిగజారిందని ఎద్దేవా చేశారు
indiatimes shopping grab discount of up to to on car interiors	ఇండియా టైమ్స్ షాపింగ్ కార్ ఇంటీరియర్స్ మీద  శాతం వరకు డిస్కౌంట్లను అందించింది
for instance do you laugh at obscene jokes	మీరు వేసుకునే బట్టలు ఇతరులను రెచ్చగొట్టేలా ఉన్నాయా
but according to the tribal king of mawsynram g	కానీ మౌసిన్రామ్లోని కొండజాతి రాజు జి
indian cricket team recently defeated bangladesh in a historic pinkball test at the eden gardens	ఈడెన్ గార్డెన్స్ వేదికగా భారత్ బంగ్లాదేశ్ మధ్య జరుగుతున్న చారిత్రక పింక్బాల్ టెస్టులో బంగ్లా టీమ్కు గట్టి షాక్ తగిలింది
exercise and activity	వ్యాయామాలు మరియు అంశాలు
montevideo the countrys capital houses the most diverse selection of cultural activities	దేశ రాజధాని మోంటెవిడియో సాంస్కృతిక కార్యక్రమాల విభిన్న ఎంపిక
he has taken five wickets in an innings three times	మూడు వికెట్లు ఐదు సార్లు తీశాడు
he was detained	ఆయన్ని చుట్టుముట్టి నిర్బంధించారు
he immediately apologised	తక్షణం క్షమాపణ చెప్పాలని ఆదేశించింది
small and medium facilitation council	చిన్న మరియు మధ్యస్థ సౌకర్యాల మండలి
surprisingly he can get emotional rather easily	కాంతికి ధ్వనికి చాలా సున్నితంగా అంటే చికాగ్గా అనిపిస్తుంది
how do airplanes fly	భగీరధుడు సముద్రాన్ని జలంతో ఎలా నింపాడు
however the sources did not divulge the name of the american diplomat	అయితే ఆ దౌత్యవేత్త పేరును మాత్రం వెల్లడించలేదు
crores	కోట్లు
manu bhaker wins gold	స్వర్ణ పథకం సాదించిన మను భాకర్
if not act fast	చేయకపోతే త్వరపడండి
excise duty on aviation fuel up	ఇంధనంపై సుంకం  శాతం పెంపు
hyderabad to emerge as aerospace defence hub	రక్షణ ఏరోస్పేస్ రంగాలకు కేంద్రంగా హైదరాబాద్
cm jagan directed the dgp and cs to be more vigilant about the safety of women	మహిళల భద్రత పట్ల మరింత జాగ్రత్తగా ఉండాలని డీజీపీ సీఎస్ లను జగన్ ఆదేశించారు
trump to impose import tariff on steel aluminium	ఇనుము అల్యూమినియం దిగుమతిపై ట్రంప్ సుంకం ప్రపంచ దేశాలు గగ్గోలు
he is a graduate of harvard university	ద  హార్వర్డ్ విశ్వవిద్యాలయం యొక్క ఒక గ్రాడ్యుయేట్
virat kohli is an exceptional leader	విరాట్ కోహ్లీ ఓ అసాధారణ కెప్టెన్
same is the case here too	ఇక్కడ కూడా అదే జరుగుతది
lakh exshowroom delhi onward	లక్షలు ఎక్స్ షోరూమ్ ఢిల్లీగా ఉన్నాయి
the ankle is not broken	నడ్డీ విరిగిన పర్లేదు
he replied likewise	వాడు కూడా అరుస్తూనే రిప్లై చేసాడు
extreme sports	ఎక్స్ట్రీమ్ క్రీడలు
crores	కోట్ల ఆదాయాన్ని ఆర్జించాం
and component conditions is very common in controllers	మరియు నియంత్రికలలో   భాగం పరిస్థితులు చాలా సాధారణం
the deceased is survived by wife two sons and a daughter	మృతుడికి ఇద్దరు కుమారులు కూతురు భార్య కేతమ్మ ఉన్నారు
general ews and obc candidates rs	లోక్సభ రాజ్యసభకు పోటీ చేసే జనరల్ ఓబీసీ అభ్యర్థులు రూ
decreased productivity	తగ్గిన దిగుబడి
ravi prakash went to high court and then to supreme court seeking anticipatory bail	గతంలో రవిప్రకాశ్ తనకు ముందస్తు బెయిల్ మంజూరు చేయాలని హైకోర్టును ఆశ్రయించినా ఫలితం లేకపోవడంతో ఆ తర్వాత సుప్రీంకోర్టును ఆశ్రయించారు
crore	కోట్లు చెల్లించింది
atom smashing machines capable of hurling particles of matter at one another now offer scientists a glimpse inside the nucleus of the atom	తత్ఫలితంగా పాజిట్రాన్లు ఫోటాన్లు మీసాన్లు క్వార్క్లు గ్లూవాన్లు వంటి వింతవింతైన పేర్లు పుడుతున్నాయి   ఇలాంటివి ఇంకా అనేకం ఉన్నాయి
the viral infections are rising in ghmc limits and surrounding areas of hyderabad	జీహెచ్ఎంసీ పరిధిలోనూ హైదరాబాదు చుట్టపక్కల ప్రాంతాల్లోనూ కరోనా వైరస్ విజృంభిస్తోంది
shrinate asked	అని శ్రీనాథుడు అడుగుతాడు
he has rs	ఆయన దర్బార్ సినిమాకు రూ
instagram music has three tabs showing popular songs moods and genres	ఇన్స్టాగ్రామ్ లో వచ్చే ఈ మ్యూజిక్ లో పాపులర్ సాంగ్స్  అలాగే మోడ్స్ జెనర్స్ ఇలా మూడు సదుపాయాలు ఉంటాయి
fire breaks out in market	మార్కెట్లో అగ్ని ప్రమాదం
many are still being treated at different hospitals	ఇప్పటికీ అనేక మంది వైద్యశాలల్లో చికిత్స పొందుతున్నారు
always follow manufacturers instructions	మీరు ఎల్లప్పుడూ ఉపయోగం కోసం తయారీదారులు సిఫార్సు సూచనలను అనుసరించాలి
pooja hegde and prabhas new movie radhe shyam is an upcoming indian romantic drama featuring actors prabhas and pooja hegde in lead roles	యంగ్ రెబల్ స్టార్ హీరోగా పూజా హెగ్డే హీరోయిన్ గా నటిస్తున్న లేటెస్ట్ అండ్ పాన్ ఇండియన్ చిత్రం రాధే శ్యామ్
kl rahul has got huge batting talent	బ్యాటింగ్లోనూ అదరగొట్టే కెపాసిటీ కేఎల్ రాహుల్కు ఉంది
it is low in calories and fat	ఇది ఒక తక్కువ పోషక విలువ మరియు కొవ్వు తక్కువగా ఉంది
total cases reported yesterday active cases deaths recovered	రాష్ట్రంలో నిన్నటిదాకా మొత్తం కేసులు  యాక్టివ్ కేసులు  మరణాలు కాగా కోలుకున్నవారి సంఖ్య
the struma and the maritsa are two major rivers in the south	ఇతర నదులలో దక్షిణాన స్ట్రామా మారిట్సా ప్రాధాన్యత వహిస్తూ ఉన్నాయి
everything does	అంతకంతా తీర్చుకుంటుంది
the other child is seven	చిన్నవాడికి రెండో ఏడు వచ్చింది
many people dont know the reality	చాలామందికి అసలు పుండు పడినట్టే తెలియదు
he had played matches for indian team	తన క్రీడాజీవితంలో అతను ఇంగ్లాండ్ జాతీయ జట్టు కేవలం  మ్యాచ్లు ఆడాడు
greetings to telangana cm kcr garu on his birthday	కెసిఆర్ జన్మదినం తెలంగాణకు పండుగరోజని చెప్పారు
high success rate	అధిక విజయం రేటు
nobody knows them	ఎవరూ తమకు తెలియదన్నారు
however congress leaders contradict the bjp claims	మరోవైపు బీజేపీ చేస్తున్న వ్యాఖ్యలపై కాంగ్రెస్ నేతలు కూడా ఎదురుదాడికి దిగుతున్నారు
tello had many illegitimate children	ఆ దంపతులకు స్వంత పిల్లలు లేరు
you can see it here	దానిని మీరు ఇక్కడు చూడండి
the political situation had changed	రాజకీయ పరిస్థితులు మారాయి
saltiness lowers the freezing temperature of water	ఉప్పు ఘనీభవన స్థానం నిరాశ ద్వారా నీటి ఘనీభవన స్థానం తగ్గిస్తుంది
ravinder was injured in the incident	ఈ ఘటనలో రవీంద్రకు తీవ్ర గాయాలయ్యాయి
it is provided free at all government hospitals	ఇది అన్ని ప్రభుత్వ ఆసుపత్రుల్లో అందుబాటులో ఉంటుంది
why should i settle down	నేనే ఎందుకు సర్దుకు పోవాలి
it was a bit messy	దాంతో కాస్త గందరగోళం తలెత్తింది
vizayanagaram ysr congress party chief ys jagan mohan reddy s praja sankalpa yatra reached vijayanagaram successfully	విజయవాడ వైఎస్సార్సీ అధినేత ప్రతిపక్షనేత వైఎస్ జగన్ చేపట్టిన ప్రజాసంకల్పయాత్ర విజయవంతంగా సాగుతుంది
repay debt	ఇక రుణం తీర్చుకోండి
she was disturbed	ఆమె మనసు కలవరపడింది
motorola unveils twoway radio	నాజుకైన రెండు ఫోన్లను విడుదల చేసిన మోటోరోలా
memory games	జ్ఞాపకశక్తి ఆటలు
telangana boy killed in us	అమెరికా కాల్పుల్లో తెలంగాణ వ్యక్తి మృతి
however no one reverted	అయినా ఎవరూ వెనుకడుగు వేయలేదు
business establishments educational and financial institutions remained closed in wake of the bandh	బంద్ నేపథ్యంలో వ్యాపార వాణిజ్య విద్యా సంస్థలను మూసివేశారు
to rs	తగ్గి రూ
thats one lucky baby	ఇది కేవలం మంచి సంతానం
was the data accurate	మీరు ఇచ్చిన సమాచారం సరైనదేనా
the cbi denied the allegations	ఆయన ఆరోపణలు సిబిఐ కొట్టి పారేసింది
motorcycle theft gang busted two held	ద్విచక్రవాహనాల చోరీ ముఠా అరెస్టు
it should be encouraged	దీనిని ప్రోత్సహించాలి
lakh rs	లక్షలు అంటే నెలకు రూ
the government is committed to early introduction of gst one of the biggest reforms in the country as early as possible	ప్రభావవంతమైన సంస్కరణలలో ఒక సంస్కరణ అయినటువంటి జిఎస్ టి ని దేశంలో త్వరితగతిన ప్రవేశపెట్టడానికి ప్రభుత్వం కట్టుబడి ఉంది
it all happened within a matter of a few seconds	ఇదంతా కొన్ని సెకన్ల లోపే జరిగినట్లు కనిపిస్తుంది
we are sportsmen	మేము క్రీడాకారులం
ram charan and jr ntr	సినిమాలో ఎన్టీఆర్రామ్ చరణ్
agriculture is in a mess	వ్యవసాయం అంటేనే రిస్కుతో కూడుకున్నది
indian batsman	క్యూకట్టిన భారత బ్యాట్స్మన్
the incident took place in east godavari district	తూర్పుగోదావరి జిల్లాలో అమానుషమైన ఘటన జరిగింది
the winter season is drawing to an end	స్కై సీజన్ ముగింపు వస్తోంది
he was my good friend at one point of time	అప్పట్లో ఆయన నాకు మంచి మిత్రుడు
issue of migrant workers	వలస కూలీల ఆందోళన
we need to explore the opportunities	అవకాశాలు వెతుక్కుంటూ మనం వెళ్లాలి
christian levantine arabs and a small number of asians and sephardic jews make up the remainder of the population	మిగిలినవారిలో క్రిస్టియన్ లెవాంటైన్ అరబ్బులు స్వల్పసంఖ్యలో ఆసియన్లు సెఫర్డిక్ యూదులు నివసిస్తున్నారు
benefits of intermittent fasting	ఉపవాస దీక్ష వలన కలిగే ప్రయోజనాలు
it surpasses the gdp of many countries	ఇది చాలా దేశాల జీడీపీ కంటే ఎక్కువ
discipline must	క్రమశిక్షణ పాటించాలి
whats everything	మంతావు
former un secretary general kofi annan	ప్రపంచం  ఐక్యరాజ్య సమితి మాజీ సెక్రటరీ జనరల్ కోఫీ అన్నన్ మృతి
i am staying in dubai	దుబాయిలో స్థిరపడ్డాం
weve made the decision to stop all political advertising on twitter globally	ప్రపంచవ్యాప్తంగా ట్విట్టర్లో అన్ని రాజకీయ ప్రకటనలను నిలిపివేయాలని నిర్ణయం తీసుకున్నాము
being sick	అనారోగ్యంతో బాధపడుతూ
whats doing well	ఏం బాగా బో హంటింగ్
do something youve never done before	మీరు ముందు ఎన్నడూ చేసినదానిని చేయండి
it is taking shape on the banks of the sabarmati river near gujarats capital gandhinagar	సబర్మతి నదికి పశ్చిమ ఒడ్డున ఉన్న గాంధీనగర్ గుజరాత్ కి కొత్త రాజధాని
no space left on device	పరికరంనందు ఇంకా ఖాళి మిగిలిలేదు
use technology	టెక్నాలజీని వాడుకోండి
it comprises three members	ఇది మూడు సభ్యులతో కూడి ఉండాలి
the total number of seats is	మొత్తం  సీట్లు ఉన్నాయి
take power	శక్తినీ అందుకుంటారు
these visible growths however are the result of noncarcinogenic hpv types	అయినప్పటికీ ఈ కనిపించే వృద్ధులు క్యాన్సర్ కాని  రకముల ఫలితం
its a good long term investment plan	దీర్ఘకాలం పెట్టుబడులకు మంచి రిటర్న్స్ ఇచ్చే స్కీమ్ ఇది
awareness through vmds covid awareness message is being published for citizens on variable messaging displays vmds placed at critical junctions of the city	వీఎండీల ద్వారా అవగాహన నగరంలోని ముఖ్యమైన కూడళ్లలో ఉన్న వేరియబుల్ మెసేజింగ్ డిస్ప్లేలపై  సందేశాలు ప్రదర్శించడం ద్వారా కొవిడ్పై అవగాహన పెంచుతున్నారు
promotes immunity	రోగనిరోధక శక్తినిస్తుంది
the scene was caught on cctv cameras	ఈ దృశ్యాలు అక్కడి సీసీటీవీ కెమెరాలో రికార్డు అయ్యాయి
certainly anything is possible	వాస్తవానికి ఏదైనా సాధ్యమే
not just weight loss	కేవలం బరువు తగ్గటమే కాదు
she acted in hindi movies too	ఆమె కన్నడ సినిమాల్లో కూడా నటించారు
the subjects english maths and telugu subjects are taught in the english medium	తెలుగు ఆంగ్లం ఉర్దూ మాధ్యమాల్లో బోధన జరుగుతుంది
crore to sell it	లక్షలకు విక్రయిస్తోంది
looking for something chic yet trendy	కొంచెం ఆధునిక ఏదో కోసం వెతుకుతున్నారా
to rs	నుండి రూ
new delhi former indian cricket team captain kapil dev has suffered a heart attack	ఢిల్లీ భారత సెలక్టర్లు జట్టు యాజమాన్యంపై భారత మాజీ కెప్టెన్ కపిల్ దేవ్ తీవ్ర అసంతృప్తి వ్యక్తం చేశారు
rrr movie is being produced by dvv danayya under dvv entertainments banner	వర్కింగ్ టైటిల్తో షూటింగ్ జరుపుకుంటున్న ఈ చిత్రాన్ని డీవీవీ ఎంటర్టైన్మెంట్స్ బ్యానర్పై డీవీవీ దానయ్య నిర్మిస్తున్నారు
big breakth	గొప్ప బ్రేక్
s it true	నిజమే కదా
godavari river	చుట్టూ గోదావరి నది
as many as persons discharged and reported dead	వీరిలో చికిత్స అనంతరం  మంది డిశ్చార్జ్ కాగా మొత్తంగా  మంది మరణించారు
but the marriage hasnt taken place yet	అయితే పెళ్లి ఇంకా నిశ్చయం కాలేదు
of nominations	ామినేషన్లు వేస్తూ
the wicked one does not benefit even if he gains wealth	యోబు      దుష్టుడు సిరిసంపదలను సంపాదించినా వాటి నుండి ప్రయోజనం పొందడు
it is easy to dismantle and assemble	వారు సమీకరించటానికి సులువుగా మరియు యంత్ర భాగాలను విడదీయు ఉన్నాయి
the incident took place in the mahbubnagar district	మహబూబ్ నగర్ జిల్లాలో ఓ ఘటన చోటుచేసుకుంది
dr arjun sharma son	డాక్టర్ అర్జున్ శర్మ కుమారుడు
im leaving	వెళ్లిపోతున్నాను మిమ్ములనందరినీ వదిలిపెట్టి
peace and tranquillity	శాంతి మరియు ప్రశాంతతను
the unity and the integrity of the country are the topmost priorities	దేశ ఐక్యత సార్వభౌమాధికారం అత్యంత ప్రాధాన్యతాంశాలు
pawan kalyan and trivikram srinivas are jointly producing the movie	శ్రేష్ఠ్ మూవీస్తో కలిసి పవన్ త్రివిక్రమ్లు ఈ చిత్రాన్ని నిర్మించడం విశేషం
rs crore	కోట్ల బడ్జెట్తో నిర్మించింది
the imd designates days as cold wave days in the plains if the minimum temperature is degrees celsius or lower and at the same time degrees or more below the average minimum temperature for the day for two consecutive days	మైదానాల్లో  డిగ్రీల సెల్సియస్ లేదా అంతకంటే కనిష్ట ఉష్ణోగ్రతలు ఉన్నప్పుడు వరుసగా రెండు రోజులు  కన్నా తక్కువ నమోదయితే చల్లని తరంగంగా ఐఎండీ ప్రకటిస్తుంది
crore indian rupees	కోట్ల రూపాయలకు కైవసం చేసుకుంది
itchy eyes	కళ్ళు ఎర్రబడుతున్న చప్పుడు
the same situation is in the whole country	రాష్ట్ర వ్యాప్తంగా ఇదే పరిస్థితి కనిపించింది
assets worth rs	వార్డెన్ ఆస్తులు రూ
check out more details within the article	మరింత సమాచారం వ్యాసంలో చూడవచ్చు
in the th century italian navigator christopher columbus wondered if he was close to rediscovering the edenic garden when he landed on the island of hispaniola now the dominican republic and haiti	ఇప్పుడు అది ఒక వరల్డ్ హెరిటేజ్ సైట్
restrictions eased down in kashmir	కశ్మీర్ లో ఆంక్షలు ఎత్తివేత
however both the films didnt fare well	ఐతే ఈరెండు చిత్రాలు అనూహ్యంగా పరాజయం చవిచూశాయి
another case was pending in the court	మరో వైపు కోర్టు లో కేసు నడుస్తోంది
the results are good	అనుకూలమైన ఫలితాలున్నాయి
dekhi hyderabad	వాహిని హైదరాబాద్
violence isnt the solution	హింస పరిష్కారం కాదన్నారంతే
but we take bath once in the morning wash our face only the next day	కానీ మేము మాత్రం ప్రతిరోజు ఉదయం ముఖం కడుక్కుంటాం స్నానం చేస్తాం
asks samujjal	అడిగాడు శామ్యూల్
music by vivek sagar is outstanding	వివేక్ సాగర్ సంగీతం పర్వాలేదు
gold and silver prices	స్థిరంగా బంగారు వెండి ధరలు
washington the presidential elections in the united states of america are underway in full swing	వాషింగ్టన్ అగ్రరాజ్యం అమెరికాలో అధ్యక్ష ఎన్నికల పోలింగ్ కొనసాగుతోంది
crores	కోట్లను తాకింది
courageous through faith and godly fear	విశ్వాసం దైవభయం మూలంగా ధైర్యంగా ఉండడం
social injustice	సామాజిక పక్షపాతం
why so vicious	అంత నిస్ఠూరం దేనికో
boy falls into water tank dies	నీటిసంపులో పడి చిన్నారి మృతి
covid cdc	కోవిడ్
how to remove stretch marks	ఎలా ముడుతలతో తొలగించడానికి ఎలా
rs onward	రూ  ఆపైన రీఛార్జిలపై రూ
gst detrimentally affected exporters and smallscale businessmen	జీఎస్టీ వల్ల వ్యాపార వర్గాలకు చిన్న వ్యాపారులకు తీవ్రమైన నష్టం జరిగిందిని అన్నారు
it improves digestion and reduces constipation	మలబద్దకాన్ని నివారించి జీర్ణక్రియను మెరుగుపరుస్తుంది
woman falls off bike dead	బైక్ పై నుంచి క్రేన్ కిందపడి యువతి మృతి
i am born and brought up in mumbai	కానీ నేను ముంబయిలోనే పుట్టి పెరిగాను
jobs and wages	జీతం మరియు వేతనాలు
lakh and rs	వేలు స్థిరాస్తులు రూ
the bjp however remained silent on the matter	అయితే ఇంతకాలం మౌనంగా ఉన్న బీజేపీ మాత్రం ఇప్పుడు ఆ విషయం బయటపెట్టేసింది
sbi is indias biggest bank	భారతదేశపు అతి పెద్ద బ్యాంక్ ఎస్బిఐ ఇపుడు పెద్ద కరెన్సీ రద్దు మార్పిడి వ్యవహారంతో కుప్పలు కుప్పలుగా డబ్బులు వచ్చి బ్యాంక్ లో డిపాజిట్ అవుతున్నాయ్
the two joined the bjp at the residence of party president amit shah	బీజేపీ జాతీయాధ్యక్షుడు అమిత్ షా సమక్షంలోనే ఇద్దరూ పార్టీలో చేరారు
former chief ministers farooq abdullah omar abdullah and mehbooba mufti are still under detention	ఇప్పటికే అక్కడ మాజీ సిఎంలు ఫరూక్ అబ్దుల్లా ఒమర్ అబ్దుల్లా మెహబూబ ముఫ్తిని గృహ నిర్బంధంలో ఉంచిన సంగతి తెలిసిందే
as a result the situation became chaotic	దీంతో పరిస్థితి గందరగోళంగా మారింది
after his death his son karan took over the reins of dharma productions	ఆయన మరణానంతరం కుమారుడు కరణ్ ధర్మా ప్రొడక్షన్స్ ను చూసుకుంటున్నారు
one can doubt it	అన్న సందేహం కలుగవచ్చు
their condition is very serious	వారి ఆరోగ్య పరిస్థితి విషమంగా ఉంది
he is the uncle of ysrcp chief ys jagan mohan reddy	ఆయన వైఎస్సార్ సీపీ పార్టీ అధినేత జగన్ మోహన్ రెడ్డి
he has struck five fours and three sixes	ఇతను ఐదు బంతులు ఎదుర్కొని మూడు పరుగులు చేసి రనౌట్ అయ్యాడు
i asked	అని మల్లికని అడిగాను
how to carve pumpkins	ఏం పుట్టగొడుగులను ఉడికించాలి ఎలా
wouldnt you know	కాదని తెలిస్తే
whether firefox fetches addon blocklist results to protect you against malicious addons defaults to on	ఫైర్ఫాక్స్ యాడ్ఆన్ బ్లాక్ జాబితా ఫలితాలు పొందుతుంది లేదో హానికరమైన పొడగింతలు వ్యతిరేకంగా మీరు రక్షించడానికి పై అప్రమేయం
no hunger	ఆకలి ఉండదు
tdp mps continue to raise slogans drowning modis speech	మోడీ ప్రసంగంపై టీడీపీ ఎంపీలు చర్చకు పట్టుబట్టాలి
it is available in two options	ఇక్కడ ఇది రెండు రకాల అందుబాటులో ఉంది
these foods are usually high in fat salt and calories	సాదారణంగా ఫాస్ట్ ఫుడ్ లో కేలరీలుఉప్పు మరియు కొవ్వు ఎక్కువగా ఉంటాయి
respectively	గానూ ఉన్నాయి
she had four children	ఆమె నాలుగు పిల్లలు జాగ్రత్త తీసుకున్నారు
method in a small pan heat the olive oil and add thyme onions and minced garlic	తయారుచేసే విధానం  పాన్లో నూనె వేసి ఉల్లిపాయ తరుగు వేగాక టమోటాలు వేసి మెత్తబడనివ్వాలి
dindori has many historical as well as spiritual places	దిండోరిలో అనేక చారిత్రక ఆధ్యాత్మిక ప్రదేశాలు ఉన్నాయి
all are playing well	అందరూ బాగా నటిస్తారు
i can say no more	అయినా చెప్పకుండా ఉండలేను
hyderabad ysr congress party ysrcp is gearing up for the upcoming elections	రానున్న ఎన్నికల కోసం వైఎస్సార్ కాంగ్రెస్ పార్టీ సంసిద్ధమవుతోంది
why are women so attracted to personalities like these	కాబట్టి స్త్రీలు స్త్రీ స్వభావం గల పురుషుల పట్ల ఎందుకు ఆకర్షితులవుతారు
the films release was delayed	దీనితో చిత్ర విడుదల ఆలస్యం అయ్యింది
wish you all the best	మీకంతా శుభాలే కలగాలి అని అన్నారు
where was it	ఎక్కడ ఉండేది
the party needs at least mlas to retain the leader of opposition status in the assembly	అందువల్ల ప్రతిపక్ష హోదా కావాలంటే కాంగ్రెస్కి కనీసం  మంది ఎమ్మెల్యేలు ఉండాలి
why did you choose tharun bhascker for the lead role	ఈ సినిమాకు తరుణ్ భాస్కర్నే ఎందుకు హీరోగా ఎంచుకున్నారు
true as far as i know	నాకు తెలిసినంత వరకు ఇది నిజం
she then called up her husband	అనంతరం తన భార్యకు ఫోన్ చేశాడు
the architecture of the temple gives us a glimpse into skills and craftsmanship of the people in assam during the ahom dynastys rule	ఈ ఆలయ వాస్తు శైలి అస్సాం లో అహోం వంశ కాలంలోని ప్రజల నైపుణ్యానికి పనితనానికి ప్రతీకగా నిలుస్తుంది
lungrelated causes	ఊపిరితిత్తుల సంబంధిత పల్మనరీ కారణాలు
ohare airport	ఓహారే విమానాశ్రయము
darbar marks superstar rajinikanth and director ar murugadoss first collaboration	సూపర్స్టార్ రజనీకాంత్  స్టార్ దర్శకుడు ఏఆర్ మురుగదాస్ కాంబినేషన్లో రూపొందుతున్న తొలి సినిమా దర్బార్
he too had remembered his grand creator in the days of his young manhood having dedicated his life to jehovah in when he was years of age	ఆయన కూడా తన మహా గొప్ప సృష్టికర్తను తన యౌవనంలోనే స్మరణకు తెచ్చుకున్న వ్యక్తి  సంవత్సరంలో ఆయనకు  సంవత్సరాల వయసున్నప్పుడు ఆయన తన జీవితాన్ని యెహోవాకు సమర్పించుకున్నారు
the condition of the farmers has only become worse	పైగా రైతుల పరిస్థితి అంతకుముందు కన్నా దుర్భరంగా మారింది
such opportunity wont come again	ఇలాంటి మంచి తరుణం మళ్లీ రాదు
he loves automobiles	ఇన్నోవా వాహనాలంటే అతనికి చాలా ఇష్టం
maruti suzuki is looking for a bigger market share in the suv segment in the indian market	మారుతి సుజుకి దేశీయ పెద్ద ఎస్యూవీల సెగ్మెంట్లో అత్యధిక మార్కెట్ వాటాను సొంతం చేసుకోవడానికి ప్రయత్నిస్తోంది
ideas are shaped	ఆలోచనలకు రూపకల్పన జరుగుతుంది
installing file	ఫైలును స్థాపిస్తున్నది
third time in a row	ముచ్చటగా మూడోసారి పోటీపడుతున్నారు
doctors are not gods	డాక్టర్లు జంతువులు కాదు
fans love seeing her pictures	ఈ ఫొటోలలో ఆమె అందాలు చూసి ముగ్దులైపోతున్నారు ఆమె అభిమానులు
below is an extensive photo gallery click to view	దీనికి చెందిన మరిన్ని ఫోటోలను వీక్షించడానికి క్రింది గ్యాలరీ మీద క్లిక్ చేయండి
the accident was one of the worst in pakistans aviation history	పాకిస్థాన్ విమానయాన చరిత్రలోనే ఘోర ప్రమాదం జరిగింది
logically jehovah would invite not just anyone but only those walking faultlessly and practicing righteousness and speaking the truth in their heart	అన్నింటికన్నా ప్రాముఖ్యంగా అది యెహోవాతో ప్రశస్తమైన సంబంధం కలిగివుండేందుకు మార్గాన్ని సుగమం చేస్తుంది
it is very high cost	ఇది అధిక ధర
the second half was a different story entirely	రెండవది అన్నమయ్య అసలు కథ ఏమిటనేది
movie director harish shankar apologised for causing inconvenience to the visitors	దర్శకుడు హరీష్ శంకర్ మాట్లాడుతూ ప్రేక్షకులకు ధన్యవాదాలు తెలిపాడు
the others are all congressmen	ఇక మిగిలిన వారంతా కాంగ్రెస్ పార్టీకి చెందిన నాయకులే
amazon founder jeff bezos and his wife mackenzie are getting divorced	అమెజాన్ వ్యవస్థాపకుడు జెఫ్ బెజోస్ ఆయన భార్య మెకన్జీ బెజోస్ల వివాహం జీవితం ఇక ముగిసిన అధ్యాయం
easy and transparent	ప్రకాశవంతం మరియు తేలిక
rajini fans in chennai are in a festive mood	చెన్నైలో రజనీ అభిమానుల ఆందోళన
jacqueline fernandez shared an array of happy pics as her instagram account surpassed million followers	తన ఇన్స్టాన్ను అనుసరించే వారి సంఖ్య  మిలియన్లు దాటడంతో కృతజ్ఞతలు చెబుతూ ఓ హాట్ ఫొటోను జాక్వలైన్ ఫెర్నాండెజ్ షేర్ చేశారు
the state ranks first in the country in production of oilseeds lentils gram soybeans garlic and tomatoes	రాష్ట్రం మామిడి బొప్పాయి నిమ్మ టమోటా మిరప పసుపు పంటల దిగుబడిలో దేశంలోనే రాష్ట్రం మొదటి స్థానంలో ఉందన్నారు
we went ahead	న ముందుంచారు
national construction company	నేషనల్ కన్స్ట్రక్షన్ కంపెనీ
miss why	భార్య ఎందుకు
amritsar three bsf soldiers injured in cross border firing	కాల్పులు ముగ్గురు బిఎస్ఎఫ్ జవాన్లకు గాయాలు
massive fire broke out at a scrap shop in visakhapatnams gajuwaka	విశాఖపట్నం నగరంలోని గాజువాకలో భారీ అగ్ని ప్రమాదం సంభవించింది
i never expected such a thing to happen	అలాంటి పరిస్థితి వస్తుందని అస్సలు ఊహించలేదు
you can post these on whatsapp facebook twitter or instagram	వాట్సాప్ ఫేస్బుక్ ట్విట్టర్ ఇమెయిల్ ద్వారా వీటిని ఉపయోగించవచ్చు
special attention is being paid to childrens education	ముఖ్యంగా దేవదాసి పిల్లలకు విద్యాభివృద్ధికి ప్రాధాన్యత కల్పిస్తున్నామన్నారు
hyderabad trs congress and bjp are gearing up for the huzurnagar byelections	హుజూర్ నగర్ ఉప ఎన్నికలను అధికార టీఆర్ ఎస్ కాంగ్రెస్ బీజేపీలు ప్రతిష్టాత్మకంగా తీసుకోంటున్నాయి
dalits do not fare better	దళితులు బాగుపడలేదు
it is easy to know	ులువైనదో తెలిసేది
why do you say so	మరి అంత తెగేసి చెప్పడానికి కారణం
who is up for a competition	అక్కడ ఎవరు పోటీ చేయాలబ్బా
the government had slashed the corporate tax rates to per cent for domestic companies and per cent for new domestic manufacturing companies as well as announcing and other fiscal reliefs in order to promote growth and investment	వృద్ధి పెట్టుబడులను ప్రోత్సహించేందుకు దేశీయ కంపెనీలకు కార్పొరేట్ పన్ను  శాతానికి తగ్గించామని నూతన తయారీ రంగ సంస్థలు  శాతం పన్ను చెల్లించే అవకాశం కల్పిస్తున్నామని కేంద్ర మంత్రి ప్రకటించారు
the list is	ఆల్రెడీ ఆ లిస్ట్
the bjp is in power in the state	రాష్ట్రంలోనూ అధికారం బీజేపీదే
take a look at ananya pandays instagram pictures	అనన్య పాండే ఇన్స్టాగ్రామ్లో పంచుకున్న ఫొటోలపై మీరు కూడా ఓ లుక్కెయండి
security deposit of rs	సెక్యూరిటీ డిపాజిట్ కట్టాల్సి ఉంటుంది
crores	కోట్ల వ్యయమవుతుంది
karnataka state imposes complete lockdown every sunday till august	ఇక కోవిడ్ రోగుల ఏకాంత గృహవాసానికి వయోపరిమితిని  సంవత్సరాలకు పెంచారు
a vacation home in goa	హాలిడే ఇన్ గోవా
he was unwell since the past few days	ఆయన గత కొద్ది రోజులుగా అస్వస్థులుగా ఉన్నారు
no changes in tax rate	ఆదాయం పన్నులో ఎలాంటి మార్పు చేయలేదు
havent you seen the movie	సినిమా చూడలేదా
dont worry about him	అతని గురించి కంగారొద్దు
a tense situation prevailed in the area	దీంతో ఒక్కసారిగా ఆ ప్రాంతంలో అలజడి వాతావరణం నెలకొంది
we are fighting	మేమిద్దరం పోట్లాడుకుంటున్నాము
the bharat bond exchange traded fund is the first corporate bond etf in the country	కాగా భారత్ బాండ్ వాణిజ్య మార్పిడి నిధి దేశంలో తొలి ఈటీఎఫ్ కార్పొరేట్ బాండ్ అవుతుంది
the examination report should be done within hours of the journey	ఈ మేరకు ప్రయాణం ముగిసిన  గంటల్లోగా పరీక్ష నివేదికను అందజేయాలి
yogendra sharma of the cpi won the seat in	లో సిపిఎం అభ్యర్దిగా గెలిచిన సన్యాసి రావు ఆ తరువాత స్వంతంత్ర అభ్యర్దిగా గెలిచారు
the cases in the country continue to rise day by day	రోజు రోజుకీ దేశంలో కేసులు పెరిగిపోతున్నాయి
new delhi indian badminton stars saina nehwal and pv	న్యూఢిల్లీ  చైనాలో జరుగుతున్న ఆసియా బ్యాడ్మింటన్ ఛాంపియన్షిప్లో భారత స్టార్ షట్లర్లు పి వి సింధు సైనా నెహ్వాల్లు శుభారంభం చేశారు
three of them are in critical condition	వీరిలో ముగ్గురి పరిస్థితి విషమం
mystery of the death of members of a family in delhis burari remains unsolved	దేశ రాజధాని ఢిల్లీలోని బురారి ప్రాంతంలో జరిగిన  మంది కుటుంబ సభ్యుల సామూహిక మరణాల ఉదంతం మిస్టరీగా మారుతోంది
whos happiest	ఎవరెవరు హర్షం వ్యక్తం చేస్తున్నారు
how to reduce stress during pregnancy	యుక్తవయస్సులో ఒత్తిడి తగ్గించడమెలా
everyones happy	అందరూ సంతోషంగా
the article is very informative	వ్యాసం ఎంతో తేజోవంతం
on the other hand metal power utilities basic materials energy and auto gained up to per cent	మరోవైపు మెటల్పవర్ యుటిలిటీస్ బేసిక్ మెటీరియల్స్ ఎనర్జీఆటో శాతం లాభపడ్డాయి
shares rallied close to in early trade	అన్ని స్టాక్స్ కూడా దాదాపు  శాతం వరకు లాభపడ్డాయి
light and dark	కోల్డ్ మరియు కాంతి
the war is ended	యుద్ధము ముగుస్తుంది
maintain self esteem	ఆత్మగౌరవాన్ని కాపాడుకోవాలి
dont forget to smile	ఎన్ని చేసినా నవ్వడం మాత్రం మర్చిపోవద్దు
the news triggered panic among villagers	దీంతో ఈ వార్త అక్కడి గ్రామస్థులను ఆశ్చర్యపరిచింది
added pressure	ఒత్తిడి పెంచారు
the bjp won seats	స్థానాల్లో గెలుపొందిన బీజేపీ
net interest income is the difference between interest earned and interest expended	సంపాదించిన వడ్డీ చెల్లించిన వడ్డీకి మధ్య తేడాను నికర వడ్డీ ఆదాయం అంటారు
the paradox of plenty	అన్నమదము
private work	ప్రైవేట్గా ఉద్యోగం చేస్తున్నాడు
state govt employees	ప్రభుత్వ ఉద్యోగులను
delhi assembly elections aap	ఢిల్లీ అసెంబ్లీ ఎన్నికల్లో ఆప్ ముందంజ
indrakaran reddy talasani srinivas yadav jagadeesh reddy etela rajendhar and others took oath as ministers	అల్లోల ఇంద్రకరణ్ రెడ్డి ఈటల రాజేందర్ జి జగదీశ్రెడ్డి తలసాని శ్రీనివాస యాదవ్ లు ఉన్నారు
she is damn gorgeous	తను చాలా అందంగా ఉంది
am i a terrorist	అయినా నేను ఉగ్రవాదినా
love birds	ప్రేమ పక్షులు
i pray for his good health modi tweeted	ఆయన మంచి ఆరోగ్యంతో ఉండాలని ప్రార్థిస్తున్నాను అంటూ మోదీ ట్వీట్ చేశారు
if it snaps	అది హిట్టయితే
vehicles being checked	వాహనాలను తనిఖీ చేస్తున్నారు
the bible speaks of jesus christ as having life in himself and of his followers as having life in themselves	యేసుక్రీస్తు తనంతటతానే జీవముగలవాడై యున్నా డు  అని ఆయన అనుచరులు  తమలో తాము జీవముగలవారు  అని బైబిలు చెబుతోంది
and all nations shall serve him and his son and his sons son until the very time of his land come and then many nations and great kings shall serve themselves of him	అతని స్వదేశమునకు కాలము వచ్చువరకు సమస్తజనులు అతనికిని అతని కుమారునికిని అతని కుమారుని కుమారునికిని దాసులైయుందురు ఆ కాలము రాగా బహుజనముల మహారాజులు అతనిచేత దాస్యము చేయించుకొందురు
whats in store for men	పురుషుల గురించి వాస్తవాలు ఏమిటి
allahabad high court verdict	అలహాబాద్ హైకోర్టు సంచలన తీర్పు
mode of operation	ఆపరేషన్ మోడ్
the brand is expected to add more cities to the dialaford service location list	ఈ బ్రాండ్ డయల్ఏఫోర్డ్ సర్వీస్ లిస్ట్లో మరిన్ని నగరాలను చేర్చుతుందని సమాచారం
im truly in shock	సలు షాక్ నేను
the expression the lip of truth is singular in hebrew and has a deeper meaning than just truthful speech	అది దృఢత్వం స్థిరత్వం విశ్వసనీయత వంటి లక్షణాలను సూచిస్తుంది  అని ఒక గ్రంథం చెబుతోంది
you need to eat right	మీరు కుడి తినడానికి అవసరం
career comeback	వృత్తి తిరోగమనం
inch full hd display	ఇంచ్ ఫుల్ హెచ్డీ ఎల్సీడీ డిస్ప్లే
he prayed to god to rest her soul in peace	ఆయన ఆత్మకు శాంతిచేకూరాలని భగవంతుని ప్రార్థిస్తున్నట్లు తెలిపారు
honor her wishes	తన ఇష్టా అయిష్టాలను గౌరవించండి
lakh crore	లక్ష కోట్లు పోయాయి
the incident took place in delhi	దేశ రాజధాని దిల్లీలో ఈ కార్యక్రమం జరుగింది
great success	అద్భుత విజయం
tdp lost a senior leader	ీడీపీ సీనియర్ నేత అవుట్
i did films	నేనే సినిమాటోగ్రఫీ చేశాను
he demanded immediate dismissal of the state government	అప్రజాస్వామిక ఆర్డినెన్స్ను రాష్ట్ర ప్రభుత్వం వెంటనే ఉపసంహరించుకోవాలని ఆయన డిమాండ్ చేశారు
no matter	లకని పట్టిందీ లేదు
chittoor ap cm chandrababu naidu has laid the foundation stone for kuppam airport	చిత్తూరు ఏపి సిఎం ఈరోజు కుప్పం విమానాశ్రయానికి శంకుస్థాపన చేశారు
doctors finally pacified him	ఎట్టకేలకు వైద్యులు ఆమెను డిశ్చార్జ్ చేశారు
in the movie mahesh babu essays the role of an army major ajay krishna	కాగా ఈ సినిమాలో మహేష్ బాబు మొదటి సారి ఆర్మీ ఆఫీసర్ పాత్రలో మేజర్ అజయ్ కృష్ణగా నటుస్తున్నారు
happy for the family	కుటుంబంలో ఆనందం నెలకొంటుంది
do not vote	ఓట్లు వేయించుకునేదిలేదు
job creation up at lakh in march epfo	మార్చిలో  లక్షల మందికి ఉద్యోగాలు ఈపీఎఫ్ఓ
lakh	లక్షలకు పెరుగుతుంది
party does not accept it	దానికి పార్టీ పర్మిషన్ తీసుకోలేదు
its not tying the hands	చేతులు గీత కాదు తాకే
you ask them	అని వారిని ప్రశ్నిస్తారా అంటూ అసహనం వ్యక్తం చేసింది
the rate rs	ల రేటు చొప్పున రూ
he got married	పెళ్లికూడా చేసుకున్నాడు
water is essential	నీరు సరిపోతుందో
kl rahul falls short of a welldeserved century	పొలార్డ్ ఊచకోతకు కేఎల్ రాహుల్ సెంచరీ చిన్నబోయింది
nabha natesh and nidhhi agerwal acted as the female leads in the movie	ఈ చిత్రంలో నిధీ అగర్వాల్ నభా నటేష్ కథానాయికలుగా నటిస్తున్నారు
jesus called satan the ruler of the world	యేసు సాతానును ఈ లోకాధికారి  అని పిలిచాడు
these antioxidants protect against cell damage	ఇక వీటిల్లోని యాంటీఆక్సిడెంట్లు కణాలు దెబ్బతినకుండా కాపాడతాయి
indian history	ఇండియన్ హిస్టరీ
whats new to watch out for	మళ్ళీ కొత్తగా పెంచడానికి ఏముంటుంది
bollywood actor nana patekar says farmers could become naxals heres why	రైతులు నక్సలైట్లుగా మారతారు నానా పటేకర్
on the front it has a megapixel selfie camera	ఫ్రంట్లో  మెగాపిక్సెల్ కెమెరా సెల్ఫీ లవర్స్ను ఆకట్టుకుంటుంది
cbi judge jagdeep singh pronounced the sentence in a special courtroom set up inside rohtaks sunaria jail where ram rahim is lodged	రోహ్తక్ జైలులో ఏర్పాటుచేసిన ఓ ప్రత్యేక గదిలో సీబీఐ కోర్టు న్యాయమూర్తి జస్టిస్ జగ్దీప్సింగ్ ఈ శిక్షను ఖరారు చేశారు
dont sit next to them on flights	విమానాలు ఎక్కితే వారి పక్కన కూర్చోవద్దు
path to salvation	సుస్థిరశాంతికి మార్గం
the court declined to pass any judgement on the posthumous mention of bose and his death	బోసు మరణం గురించి కాని మరణానంతర ప్రస్తావన గురించి కాని ఎటువంటి వ్యాఖ్యలు చేయడానికి నిరాకరించింది
devi sri prasad has rendered the music	దేవిశ్రీ ప్రసాద్ ఎక్స్ట్రార్డినరీ మ్యూజిక్ను అందించారు
accordingly the japan became the second biggest economic system in the world	ప్రకారం జపాన్ ప్రపంచంలో రెండవ పెద్ద ఆర్ధిక వ్యవస్థ
as for the headroom and cabin space the celerio is practical and ease to drive is good	సెలెరియోలోని క్యాబిన్ వెనుక భాగం గురించి చర్చించుకుంటే లెగ్ రూమ్ మరియు హెడ్ రూమ్ ఎంతో సౌకర్యవంతంగా విశాలంగా ఉంటుంది
trs in telangana has slipped quite badly in the lok sabha elections	ఈ ఎన్నికల్లో టీఆర్ ఎస్ ఘోరంగా ఓడిపోయింది
not so anymore	ఇక అలా కాదు
it was delayed	అది వాయిదా ప డింది
gauri khan the wife of bollywood star shah rukh khan has carved a niche for herself in the field of interior design	బాలీవుడ్ బాద్ షా షారూఖ్ ఖాన్ భార్య గౌరీ ఖాన్ ఇంటీరియర్ డిజైనింగ్ లో ఎక్స్ పర్ట్ అన్న విషయం తెలిసిందే తాను డిజైన్ చేసిన ప్రాజెక్
refer to the table below	దిగువ పట్టిక చూడండి
why are we fearing it so much	మరి అంత భయం భయంగా రాయడం ఎందుకు
lakh loss	లక్షల నష్టం
crore was allocated	కోట్లు కేటాయించింది
barack obama	బారక్ ఒబామా
the madhya pradesh government too has taken the initiative and opened a resort facing the dam which gives a breathtaking view of the entire dam and the reservoir	మధ్యప్రదేశ్ ప్రభుత్వం కూడా ఈ డ్యాం ని పర్యాటక ప్రాంతం గా ప్రసిద్ది చేసేందుకు ప్రయత్నంగా ఈ డ్యాం కి ఎదురుగా ఒక రిసార్ట్ ని నిర్మించింది
his son maharana pratap of mewar firmly resisted the mughals	అతని కుమారుడు మేవారు మహారాణా ప్రతాపు మొఘలులను గట్టిగా వ్యతిరేకించారు
the boat broke in the water	దీంతో బోటు సముద్రంలో మునిగిపోయింది
father retired	నాన్నగారు రిటైరైపోయారు
executive director	కాన్ఫిడెంట్ డైరెక్టర్
the cemetery boundaries are unchanged since	నుండి మాండ్య జిల్లాలోని తాలూకాలు మార్చకుండా స్థిరంగా ఉన్నాయి
crores	కోట్లు ఇచ్చారు
the incident took place near thrissur kerala	ఈ ఘటన కేరళాలోని త్రిస్సూర్లో చోటు చేసుకుంది
at every turn	ప్రతి వైపు
need to change the practice	అలవాట్లలో మార్పులు అవసరం
it is better to completely avoid alcohol	మద్యం పూర్తిగా మినహాయించాలని ఉత్తమం
humans use building materials to construct shelters	మానవులు భూమిపై లభించే నిర్మాణ సామాగ్రిని వాడి నివాసాలను నిర్మిచుకుని జీవిస్తారు
we had doubts	దీంతో మాకు అనుమానం వచ్చింది
bradon leaves after a few days and heath stays until the night of the party when he is unexpectedly found by easy	కొద్ది రోజుల తరువాత పటేల్ వచ్చినపుడు ప్రోటోకోల్ ప్రకారం స్వాగతం పలకవలసి ఉండగా నిజాము ముందు అందుకు సమ్మతించలేదు
however rs	అయితే వాటితో కలిపి రూ
modi in america	అమెరికాలో మోడీకి జేజేలు
how would it decide	ఆ నిర్ణయం ఎలా ఉండొచ్చు
who won who lost	ఎవరు గెలిచారు ఎవరు ఓడారు
power capital goods it banking and financial sectors look positive whereas pharma looks negative	బ్యాంకింగ్ ఐటీ టెక్నాలజీ హెల్త్ కేర్ సెక్టార్లు నెగిటివ్గా ఉండగా ఆటో ఎఫ్ఎంసీజీ కన్జూమర్ డ్యూరబుల్స్ రంగాల్లోని షేర్లు పాజిటివ్గా ఉన్నాయి
abrars death	బాబర్ మరణం
game time	గేమ్ సమయంలో
words of inspiration	ఇన్స్పిరేషనల్ వర్డ్స్
do you drink	పొద్దునే్న తాగావా
belt and road	బ్యారక్ అండ్ రోడ్
he plays for sunrisers hyderabad in the indian premier league ipl	ఢిల్లీ ఇండియన్ ప్రీమియర్ లీగ్ ఐపీఎల్లో సన్రైజర్స్ హైదరాబాద్కు ఆడటమే తన
just one million	కేవలం లక్షన్నర
how can apply	అభ్యర్థించవచ్చు ఎలా
bangladesh arrests mastermind of blogger murders	బంగ్లాదేశ్ బ్లాగర్ దారుణ హత్య
the panel includes	మడత పట్టిక క్రింది లక్షణాలను కలిగి ఉంటుంది
the benefits of exercise during pregnancy	ప్రెగ్నెన్సీ అప్పుడు చేసే వ్యాయామం వల్ల కలిగే అద్భుత ప్రయోజనాలు
the ship stopped just short	అప్పుడే పడవ వచ్చి ఆగింది
batting firstmaharashtra put on runs for the loss of five wickets in their allotted overs	ఇదిలా ఉండగా తొలుత టాస్ ఓడి బ్యాటింగ్ చేసిన భారత్ నిర్ణీత  ఓవర్లలో ఎనిమిది వికెట్లు కోల్పోయి  పరుగులు చేసింది
oil prices could drop substantially	ముడి చమురు ధరలు భారీగా పతనం
he looks it too	ఆయన కూడా చూడండి అన్నారు
then add the carrots	అప్పుడు టమోటాలు జోడించండి
boosts immunity in the body	శరీరంలో రోగనిరోధక శక్తిని పెంచుతుంది
the pictures of them together are floating on the internet	అతిసన్నిహితంగా కలిసి ఉన్న వారిద్దరి ఫొటోలు ఇంటర్నెట్లో వైరల్గా మారాయి
these products can further be divided into two subcategories	ఈ ఉత్పత్తులు రెండు గ్రూపులుగా విభజించవచ్చు
congress leaders placated	కాంగ్రెస్ లీడర్స్ మెమోరాండం
its simple and easy to use	వాటిని ఉపయోగించి చాలా సాధారణ మరియు సౌకర్యవంతంగా ఉంటుంది
free eye operations	ఉచితంగాఅనేక ఆపరేషన్స్
he expressed profound sympathy to their family members	వారి కుటుంబ సభ్యులకు తన ప్రగాఢ సానుభూతి తెలిపారు
the death toll climbed to	మరణాల సంఖ్య కి పెరిగింది
four killed in road accident in kurnool	కర్నూలు జిల్లాలో రోడ్డు ప్రమాదం  ఆరుగురు మృతి
hes got it	ఆయనకున్నది
government has committed rs	సెబీ ద్వారా ప్రభుత్వం రూ
the district magistrate	జిల్లా మెజిస్ట్రేట్ సమాధానం
but these werent implemented	కాని ఇవేవీ అమలుకు నోచుకోలేదు
jhum cultivation is especially common	కర్మజన్మ తాజా పుస్తకం
he gave runs in his four overs	తన తర్వాతి రెండు ఓవర్లలో కలిపి  పరుగులు సమర్పించుకున్నాడు
turmoil in the coalition government	సంకీర్ణ సర్కారులో లుకలుకలు
the state of rice farmers is no different	వ్యవసాయ కూలీల పరిస్థితి కూడా ఇందుకు భిన్నంగా లేదు
lakh to the chief ministers relief fund	లక్షలు ఏపీ ముఖ్యమంత్రి సహాయనిధికి అందించారు
it costs	దీంతో ఖర్చు
cyber weapons	సైబర్ ఆయుధం
bollywood career	బాలీవుడ్ కెరీర్
srinagar district rs	శ్రీరాంసాగర్ సెగ్మెంట్ పరిధిలో రూ
the bhai asked	అడిగాడు భీమయ్య
curly hair	రేగే జుట్టు వంకీలు
happy republic day wishes	గణతంత్ర దినోత్సవ శుభాకాంక్షలు తెలిపిన తారలు
shining bright in dark	కటిక చీకట్లో సన్నసన్నగా వెలుగుతూ
first month	మొదటి నెల రూ
president pranb mukherjee congratulated isro for the successful test	మంగళయాన్ను విజయవంతం చేసిన ఇస్రో శాస్త్రవేత్తలకు భారత రాష్ట్రపతి ప్రణబ్ ముఖర్జీ అభినందనలు తెలిపారు
santa cruz de la palma known to those on the island as simply santa cruz is its capital	దీని రాజధాని శాంటా క్రుజ్ డి లా పాల్మ కేవలం శాంతా క్రజ్ గా ద్వీపవాసులు వ్యవహరిస్తారు
i pursed my lips	పెదవి విరిచాను
camera features	కెమెరా ఫీచర్
the modi government has opened the door for intrusion of foreign capital in the country	మేకిన్ ఇండియా నినాదాన్ని గాలికి వదిలేసి విదేశీ పెట్టుబడులకు తలుపులు బార్లా తెరిచింది మోడి ప్రభుత్వం
valentino rich life in jehovahs service r	విధేయత   బాల్యంలో నేర్చుకోవలసిన ముఖ్యమైన పాఠము
the second game was more thrilling	రెండో గేమ్ సైతం ఉత్కంఠ భరితంగా సాగింది
atal bihari vajpayee was one of them	వారిలో ముఖ్యులు అటల్ బిహారీ వాజ్ పేయి
brain activity	బ్రెయిన్ యాక్టివిటీ
i knew her through a common friend	ఆయన ఒక కామన్ ఫ్రెండ్ ద్వారా కలిశాను
tamil music director anirudh ravichander is composing the music	తమిళ సంగీత దర్శకుడు అనిరుధ్ సంగీతం అందించనున్నారు
theres a megapixel selfie camera on the front	మెగాపిక్సల్ ముందు కెమెరాతో సెల్ఫీలు ఆకట్టుకుంటాయి
people gathered near the accident spot	యాక్సిడెంట్ జరిగిన ప్రదేశంలో జనం గుమిగూడారు
for australia josh hazlewood bagged four wickets while nathan lyon took two wickets	ఆస్ట్రేలియా బౌలర్లలో నాథన్ లియోన్ మూడు వికెట్లు కైవసం చేసుకోగా జోష్ హాజెల్వుడ్ రెండు వికెట్లు పీటర్ సిడిల్ ఒక వికెట్ చొప్పున సాధించారు
the rent court	అద్దె కోర్టు
the government has given the option for people who live close to the rivers to carry sand in bullock carts for free	నదీ పరిసర ప్రాంతాల ప్రజలు సొంత అవసరాల కోసం ఎడ్ల బండ్లలో ఇసుకను ఉచితంగా తీసుకెళ్లే వెసులుబాటును ప్రభుత్వం కల్పించింది
buying a new phone	కొత్త ఫోన్ కొనాలంటే
go and search for it	వెళ్లి అడిగి చూడు
he is survived by his wife girija rajasekharan two sons and two daughters	ఆయనకు భార్య గిరిజా రాజశేఖరన్ ఇద్దరు కుమారులు ఇద్దరు కుమార్తెలు ఉన్నారు
priced at	కే ఆఫర్ చేస్తోంది
his leg was broken	దాని కాలికి దెబ్బ తగిలింది
eventually the movie was ready for release	ఎట్టకేలకు మూవీని ప్రారంభించేందుకు సిద్దం చేశారు
dil raju is the films producer	దిల్ రాజు ఈ సినిమాకి నిర్మాతగా వ్యవహరిస్తున్నాడు
he died at the age of eightyfive	ఆయన తాగి తాగి యాభై ఏళ్ల లోపలే చనిపోయారు
control blood cholesterol level	కొలెస్ట్రాల్ లెవల్స్ ను కంట్రోల్ చేస్తుంది
is it a marriage	పెళ్లి అయితే అంతేనా
if it doesnt happen then it doesnt happen	ఒకవేళ అది జరగదు ఒకవేళ ఒకవేళ ఒకవేళ ఒకవేళ ఒకవేళ ఒకవేళ
divyas postmortem report revealed injury marks on her body	హత్యకు గురైన దివ్య మృతదేహానికి పోస్టుమార్టం నిర్వహించగా ఆమె శరీరంపై  గాయాలు ఉన్నట్లుగా గుర్తించారు
whats to celebrate	ఏమి జరుపుకోవాలి
its okay	పర్వాలేదు బాగున్నా
how was the casting done	ఆడిషన్ ఎలా జరిగింది
top button d	పైన బటన్
million	లక్షలు
but not everyone	అయితే అందరికీ మాత్రం కాదు
who was driving the car is yet to be known	ఇంతకీ కారు నడుపుతున్నదెవరో తెలియని గందరగోళం నెలకొంది
dark games	నిశ్శబ్ద ఆటలు
its just a language	ఇది ఒక భాష ఒంటరిగా ఉంది
it is quite comfortable here	ఇక్కడ హాయిగా కూడా వున్నది
come and sit down	లోపలికి రా కూర్చో అని సీట్ చూపెట్టింది
always speak the truth	ఎల్లప్పుడూ నిజం చెప్పండి
the majority of these cases are in mainland china	ఈ కేసులలో అత్యధికం చైనాలోనే ఉన్నాయి
couple killed in road mishap	దారుణం రోడ్డు ప్రమాదంలో భార్యాభర్తల మృతి
at the moment	అని తెలిపారు
hell be here	అతను ఇక్కడే ఉంటాం
is rs	సంవత్సరానికి తనకు రూ
theres a few things i learned while doing these day challenges	ఈ  రోజులు పాటించే విధానములో నేను కొన్ని విషయాలను నేర్చుకున్నాను
amending labour laws	కార్మిక చట్టాల సవరణ సరికాదన్నారు
the court sentenced him to seven years imprisonment	కోర్టు రోజ్ ఏడు సంవత్సరాల జైలు శిక్ష విధించింది
indias capacity potential and energy are unmatched	వనరులు సామర్థ్యం శక్తి ఎందులోనూ భారత్ బలహీనం కాదని చెప్పారు
tucson prime a street dog was often seen hanging out near a hyundai car showroom in brazil	టక్సన్ ప్రైమ్ ఒక వీధి కుక్క బ్రెజిల్ దేశంలోని హ్యుందాయ్ కార్ షోరూమ్ దగ్గర తరచూ కనిపిస్తుంటుంది
if not treated immediately it can be fatal	వెంటనే చికిత్స చేయకపోతే ప్రాణాల మీదికీ రావొచ్చు
chhattisgarh in chhattisgarh corona intensive community survey campaign is going on	ఛత్తీస్గఢ్ రాష్ట్రంలో కరోనా ఇంటెన్సివ్ కమ్యూనిటీ సర్వే కార్యక్రమం కొనసాగుతోంది
its the same in a family too	కుటుంబ విషయములలోనూ వీరికి యిదే జరుగును
sivaramapuram agraharam is a village located close to the thirumanancheri temple	తిరుమనంచేరి టెంపుల్ కి దగ్గరలోని గ్రామం ఈ శివరామపురం అగ్రహారం
later on wardha was ruled by chalukyas rashtrakutas yadavas delhi sultanate bahamani sultanate muslim ruler of berar gonds and maratha	తరువాత వార్ధాను చాళుఖ్యులు రాష్ట్రకూటులు దేవగిరికి చెందిన సెయునా యాదవులు ఢిల్లీ సుల్తానులు బహమనీ సుల్తానులు బేరర్కు చెందిన ముస్లిం పాలకులు గోండులు మరాఠీలు పాలించారు
vasu dev was of buddhist origin but later started following brahminical practices	వాసుదేవ్ బౌద్ధ మూలానికి చెందినవాడు కాని తరువాత బ్రాహ్మణ పద్ధతులను అనుసరించాడు
nicobar islands are likely to experience heavy rainfall at isolated places on nd rd may	నికోబార్ దీవుల్లో అక్కడక్కడా మే నెల రెండు మూడు తేదీల్లో భారీ వర్షాలు పడే సూచనలున్నాయి
cheers to health	జామాకులతో ఆరోగ్యం
yes it does if you want to practice the christianity taught in the bible itself	అవును ఒకవేళ మీరు బైబిల్లో ఉన్న విషయాలు పాటించాలనుకుంటే అవసరమే
the thirukannapuram neelamega perumal temple in thiruvarur dates back to the th century ad and is dedicated to the worship of lord shiva	తిరువరూర్ లో తిరుకన్నపురం నీలమేఘపెరుమాల్ ఆలయం క్రీశ  వ శతాబ్దం క్రిందటిది ఇక్కడ శివుడిని పూజిస్తారు
islam and peace	ఇస్లాం మరియు శాంతి
people are confined to their houses	ప్రజలెవ్వరూ బయటకు రాకుండా తమ తమ ఇళ్లకే పరిమితం అవుతున్నారు
telangana government allotted rs	పద్మ శ్రీ పురస్కారం పొందిన కనకరాజు సేవలకు గుర్తుగా తెలంగాణ రాష్ట్ర ప్రభుత్వం తరుపున రూ
he is unlikely to run in the next election	వచ్చే ఎన్నికలకు ఆయన ప్రధాని అభ్యర్ధిగా ఉండే అవకాశం లేదు
bright blue	లేత నీలం ఓణీ
not next week	వారం తర్వాతకాదు రేపటినించే
but killing is not a solution	ందుకుంటుంది అయితే మరణం దీనికి పరిష్కారం కాదు
superstar mahesh babu is basking in the glory of his recent outing maharshi which has smashed every possible box office record	కాగా మహేష్ బాబు లేటెస్ట్ మూవీ మహర్షి బాక్సాఫీస్ వద్ద నాన్ బాహుబలి రికార్డులన్నీ బద్దలు కొడుతూ దూసుకెళుతోంది
uhhuh	య్యయ్యో ఛీ ఛీ
shraddha kapoor is the daughter of the renowned actor shakti kapoor	మేటి నటుడు శక్తి కపూర్ కుమార్తెనే శ్రద్దా కపూర్
would his extraordinary strength save him	ఆయన అసాధారణమైన శక్తి ఆయనను కాపాడిందా
how many draws	ఎన్నిరకాల గమనాలు
dhoni stands fifth on the list	జాబితాలో పదవది హ్యూందాయ్ ఇయాన్
keerthy suresh and anu emmanuel are the leading ladies	కీర్తి సురేష్ అను ఇమ్మాన్యుయేల్ కథానాయికలు
you can see the video here	సదరు వీడియోను మీరూ చూడవచ్చు
cowpea rs	నాయుపేటకు రూ
blatant murders	ఆగని భ్రూణ హత్యలు
he didnt look back thereafter	ఆ తర్వాత అతను వెనుదిరిగి చూడలేదు
it comes in black colour only	ఇది కేవలం నలుపు రంగులోనే అందుబాటులో ఉంటుంది
by using of course bernoullis equation or in the differential form the euler equation we can say if the velocity reduces so the pressure has to increase	కోర్సు బెర్నౌలీ యొక్క సమీకరణం లేదా భేదాత్మక రూపంలో ఉపయోగించడం ద్వారా డ్యులార్ సమీకరణం వేగం వేగం తగ్గిపోతే ఒత్తిడి పెరుగుతుంది
up to rs lakh	లక్షల పరిమితి వరకు రూ
the day temperature continues to plummet across the state	రాష్టవ్య్రాప్తంగా పగటి ఉష్ణోగ్రతలు రోజు రోజుకీ పెరుగుతున్నాయి
leave overnight	రాత్రిపూట వదిలివేయండి
who you are	ఎవరు బాబూ మీరు
music is the same	నేపధ్య సంగీతం ఓకే
financial department	ఆర్థిక వ్యవస్థ
e a b d c	ఎ సి ఎ బి ఎ
somehow the girl escaped and returned home	తర్వాత ఎలాగోలా తప్పించుకొని ఇంటికి చేరింది యువతి
home language tab queue	ముంగిలి భాష ట్యాబుల వరుస
click photos	ఫోటోలు తాకడం
rani mukherjee and kamal haasan	కమల్ హాసన్ రాణి ముఖర్జీ
crores	కోట్లు కట్టాల్సి ఉంది
japan became more stronger in th century	వ శతాబ్దం ఆరంభంలో జపాన్ మరింత బలపడింది
mantora babi	మంటోరా బాబీ
chandrababu meets bardhan	చంద్రబాబుతో మోహన్బాబు భేటీ
the national food security act nfsa provides coverage to nearly crore persons to receive highly subsidised foodgrains through targeted public distribution system tpds under two categories vizantyodaya anna yojana aay and priority households phh which is nearly rdof the countrys population as per the census of	జాతీయ ఆహార భద్రత చట్టం  ఎన్ఎఫ్ఎస్ఏ లక్షిత ప్రజా పంపిణీ వ్యవస్థ టిపిడిఎస్ ద్వారా రెండు వర్గాల కింద అధిక సబ్సిడీ కలిగిన ఆహార ధాన్యాలను పొందటానికి దాదాపు  కోట్ల మందికి కవరేజీని అందిస్తుంది
stage iii	స్టేజ్ మూడు
onion cup finely sliced	పన్నీర్   కావాల్సిన సైజ్ లో కట్ చేసుకోవాలి
yes and it was terrible	ఓహ్ మరియు అది భయంకరమైన ఉంది
new possibilities emerge	కొత్త అవకాశాలు తెరవబడతాయి
everyone must wear a mask	మాస్కులను ప్రతి ఒక్కరూ ధరించాలని అన్నారు
error reading gconf string value s s	పదబంధ విలువను చదువుటలో దోషం
tata motors is all set to introduce the new premium suv and a hatchback in the indian market	విపణిలో ఎక్కువ డిమాండ్ ఉన్న ప్రీమియం హ్యాచ్బ్యాక్ మరియు ఖరీదైన ప్రీమియం ఎస్యూవీల సెగ్మెంట్లోకి రెండు కొత్త మోడళ్లను విడుదల చేయడానికి టాటా మోటార్స్ దాదాపు సిద్దమైంది
further the promoters shared the challenges faced in running the cold chain projects during the lockdown period	దీనికి తోడు ప్రమోటర్లు లాక్డౌన్ కాలంలో కోల్డ్ చైన్ ప్రాజెక్టులను నడపడంలో ఎదుర్కొంటున్న సవాళ్లను పంచుకున్నారు
the case is being monitored by the supreme court	ఈ కేసును హైకోర్టు పర్యవేక్షిస్తోంది
the siddheshwar temple is an iconic temple situated in the middle of a beautiful lake and is surrounded by water on all sides	సిద్దేశ్వర దేవాలయం ఒక అందమైన సరస్సు మధ్య ఉండి అన్ని వైపుల నీటితో చుట్టబడి ఉంది
enable backoff and startstop buttons	బ్యాక్ఆఫ్ మరియు ప్రారంభంఆపివేయు బటన్లను చేతనంచేయుము
ram charan and jr ntr are playing the lead roles in the movie	ఎన్టీఆర్ రామ్ చరణ్ లు హీరోలుగా మరెంతో మంది ప్రముఖ తారాగణం నటిస్తుండగా తెరకెక్కుతున్న పాన్ ఇండియా సినిమా
mix the lemon juice and chopped coriander leaves	తరిగిన మెంతులు మరియు నిమ్మ రసంతో కలపాలి
we are yet to receive payment	మన దగ్గర ఇంకా చలానాలు వసూలు చేస్తున్నట్టు లేరు
bse midcap up a marginal	బీఎస్ఈలో మిడ్ క్యాప్స్  శాతం బలహీనపడింది
train number raipurvisakhapatnamraipur passenger and	రాయపూర్  విశాఖపట్నం  రాయ్పూర్ పాసింజర్ రైలును రెండు
market capitalisation crossed rs one lakh crore	లక్షకోట్ల మార్కెట్ విలువలను దాటేసింది
people identification of trilinga nation budrudhara	బరుదారఁ ద్రిలింగదేశ మనఁజనుఁ గృతులన్
some achieve it	వాటిని కొందరు అధిగమిస్తారు
asked the villagers	్రామస్తులు వచ్చి ప్రశ్నించారు
one is not born but rather becomes a woman wrote simone de beauvoir in her seminal book the second sex	సెకండ్ సెక్స్లో  సైమన్ డి బ్యూవోర్ ప్రముఖంగా పేర్కొన్నాడు వన్ జననం లేదు కానీ అది ఒక స్త్రీ అవుతుంది
producer bvsn	ఈ చిత్ర నిర్మాత బివిఎస్ఎన్
theres no development	అభివృద్ధి కనపడడు
but nowthe composition has resurfaced	అయితే ఇప్పుడీ కాంబినేషన్ మరోసారి జతకట్టనుంది
hey cunt	ఓరీ కిరాతకుడా
must listen	తప్పక మాట వింటారు
it is going to encourage investment	పెట్టుబడులలో ప్రోత్సాహం లభిస్తుంది
you are in cape canaveral and you are head of mission control	మీరు కేప్  ఉన్నాయి మరియు మీరు మిషన్ కంట్రోల్ హెడ్ ఉన్నాయి
maharshi directed by vamsi paidipally stars mahesh babu pooja hegde allari naresh and jagapathi babu in the lead roles	సూపర్ స్టార్ మహేష్ బాబు  పూజా హగ్దే జంటగా అల్లరి నరేష్ కీలక పాత్ర లో వంశీ పైడిపల్లి డైరెక్షన్లో తెరకెక్కుతున్న చిత్రం మహర్షి
priced at rs	కు అమ్ముకున్నారన్నారు
the plane landed safely	చివరికి సేఫ్ గా విమానం ల్యాండ్ అయింది
and division no	ఓ అండ్ ఎ డివిజన్ నం
the horn of mortal danger	ప్రాణాపాయము
whats the temperature	సి లో ఉష్ణోగ్రత అంటే ఏమిటి
pm modi reaches out to opposition	ప్రతిపక్షాలకు ప్రధాని మోడీ విజ్ఞప్తి
how safe are you online	ఆన్లైన్లో మీరు ఎంతమేరకు సురక్షితంగా ఉన్నారు
whats an open license	ఓపెన్ లైసెన్స్ అంటే ఏమిటి
the city is connected to major cities and towns by means of road and railways	బాందా నుండి ముఖ్యమైన పట్టణాలు నగరాలకు రైలు రోడ్డు మార్గాలున్నాయి
the report is yet to be made public officially	ఈ వార్తను ఇంకా అధికారికంగా ప్రకటించాల్సివుంది
yeah come on in	అవును సైన్ నమోదైనవి
due to the intensity of the blast the roof of the house collapsed	గాలి తీవ్రత ఎక్కువగా ఉండడంతో ఇల్లు పేక మేడల్లా కూలిపోయాయి
kcr asked	అని ప్రశ్నించారు సీఎం కేసీఆర్
related article	సంబంధిత వ్యాసం
i am now conducting home bible studies	నేను ఇప్పుడు  గృహ బైబిలు అధ్యయనాలు నిర్వహిస్తున్నాను
tech student commits suicide	ఉరి వేసుకుని డిగ్రీ విద్యార్థి ఆత్మహత్య
interviewing candidates	ఇంటర్వ్యూయింగ్ అభ్యర్థులు
bjp demanded an nia investigation into the blast	ఈ దాడిపై విచారణ జరగాలని బీజేపీ డిమాండ్ చేస్తోందని చెప్పారు
however rs	అయితే ఏజెంట్లకు రూ
i watch a lot of films	వందల సినిమాలు చూసినోడ్ని
so again worker is busy in m now	కాబట్టి మళ్ళీ కార్మికుడు ఇప్పుడు  లో బిజీగా ఉన్నాడు
audio and video	వీడియో ఆడియో
but still he kept working	అయినప్పటికీ ఆపకుండా ఆ పనిచేస్తూనే ఉన్నాడు
the meeting was attended by uttam kumar reddy state congress president l ramanna state tdp president e dayakar rao tdp floor leader in the assembly and chintala ramachandra reddy bjp mla	ఈ కార్యక్రమంలో టిటిడిపి అధ్యక్షుడు ఎల్ రమణ ఎపి మంత్రి పల్లె రఘునాధరెడ్డి టిడిపి నేతలు కొత్తకోట దయాకర్రెడ్డి మోత్కుపల్లి నర్సింహులు బొండా ఉమా మల్కాజ్గిరి ఎంపి మల్లారెడ్డి రమేష్రాథోడ్ తదితరులు పాల్గొన్నారు
thats a long time consuming discussion	ఇది సుదీర్ఘంగా చర్చించాల్సిన అంశమన్నారు
pawan attended the audio release event as a chief guest	కోటి దీపోత్సవం కార్యక్రమానికి పవన్ ముఖ్య అతిథిగా హాజరయ్యారు
but the process took much more time	అయితే ఈ ప్రక్రియ రోజు ఎక్కువగా పడుతుంది
local attraction	స్థానిక ఆకర్షణలు
do not do it	చస్తే చేయొద్దు
the release date of the movie is yet to be announced	ఈ సినిమా విడుదల తేది ఇంకా తెలియాల్సి ఉంది
new hero	కొత్త హీరో
the translators accumulated word list led to the publication of a tuvaluan english dictionary in	ఆ అనువాదకుడు సేకరించిన ఆ పదాల పట్టిక లో తువాలియన్  ఇంగ్లీష్ నిఘంటువును ప్రచురించడానికి నడిపించింది
self confidence increases	ఆత్మవిశ్వాసం పెరుగుతుంది
rape and murder	దోపిడీ మరియు హింసకు
but each ailment requires a particular treatment	కానీ ప్రతి సందర్భంలో మీరు ప్రత్యేక ఔషధం అవసరం
swenson died in of aidsrelated illness	ఫెలెప్పా లో సంబంధిత మెదడు రక్తసావ్రం కారణంగా మరణించాడు
eating outside food is strictly prohibited	బయటి ప్రాంతాల్లో ఆహార పదార్థాలు తినడం లేదా తయారు చేయడం అనేది పూర్తిగా నిషేదించారట
it includes the following activities	ఇది క్రింది కార్యకలాపాలను కలిగి
the congress and the ncp opposed the abrogation of article	ఆర్టికల్  రద్దును కాంగ్రెస్ ఎన్సీపీలు సిగ్గులేకుండా వ్యతిరేకిస్తున్నాయని మండిపడ్డారు
smashing heads	తలలు పగలడం
however she did not budge	అయినా ఆమె పట్టువీడలేదు
these options however are not seamless	కానీ ఈ ఎంపికలు అంతం కాదు
read the resolution below	క్రింది డెఫినిషన్ చదువుతుంది
dr pronab sen chairman national statistical commission was the guest of honor	నేషనల్ స్టాటిస్టిక్స్ కమిషన్ చైర్మన్ డాక్టర్ ప్రణబ్ సేన్ గౌరవ అతిథిగా పాల్గొన్నారు
metro rail lanes would be constructed according to the inner ring road	ఇన్నర్ రింగ్రోడ్లకు అనుసంధానంగా మెట్రో రైల్ లైన్ నిర్మిస్తారు
he has a small child	అతనికి ఒక మైనర్ కుమారుడున్నాడు
one other individual survived	మరో వ్యక్తి పరారయ్యాడు
the movie is directed by anand annamalai who makes his debut as a director	ఆనంద్ అన్నామలై దర్శకుడిగా పరిచయం అవుతున్నారు
theres a price to pay however	అయితే దీనికోసం కొంత రుసుము చెల్లించాలి
the movie is being directed by radha krishna	ఈ సినిమాను రాదా కృష్ణ నిర్మిస్తున్నాడు
the marriage laws of the reang are few but well defined	రీయాంగు వివాహ చట్టాలు చాలా తక్కువ కానీ బాగా నిర్వచించబడ్డాయి
connection of these generators to the utility grid requires synchronization conditions to be met	ఈ జనరేటర్లను యుటిలిటీ గ్రిడ్కు అనుసంధానించడానికి సమకాలీకరణ పరిస్థితులు అవసరం
a humans	నుషులేనా
all the songs attained immense popularity	అన్ని పాటలు మంచి ప్రజాదరణ పొందాయి
its a normal household	ఆమె ఓ సాధారణ గృహిణి
crore and rs	కోట్లు చిరంజీవి రూ
schedule of deepika shraddha saras appearances before ncb	ఎన్సీబీ ఎదుటకు దీపిక సారా శ్రద్ధా
leadership change	నాయకుని మార్పు
mahindra to launch more a powerful reva eo in europe	యూరప్ మార్కెట్ కోసం పవర్ఫుల్ మహీంద్రా ఈఓ
loss of smell	దుర్వాసననూ పోగొడతాయి
health benefits of almonds	మకాడమియా నట్స్ యొక్క ఆరోగ్య ప్రయోజనాలు
it has the locals scared	దీంతో స్థానికులు భయభ్రాంతులకు గురి అవుతున్నారు
he had acted in over films	కి పైగా సినిమాలకు ఆయన మాటల రచయితగా పని చేశారు
pune university	యూనివర్సిటీ ఆఫ్ పుణే
so be cautious	కాబట్టి జాగ్రత్తగా ఉండు
i consistently prayed to jehovah for guidance in making the right decision kwabena ghana	సరైన నిర్ణయం తీసుకోవడానికి నడిపించమని నేను యెహోవాకు క్రమంగా ప్రార్థించాను   క్వాబెనా ఘానా
a dispute has erupted in the family	దీంతో కుటుంబంలో కలహాలు ప్రారంభమయ్యాయి
rep	మ రాక్షస
but such calamities the scriptures explain are due to time and unforeseen occurrence not our horoscope ecclesiastes	కానీ అలాంటి విపత్తులు జాతకచక్రం మూలంగా కాదుగానీ  కాలవశముచేతను అనూహ్యంగాను  జరుగుతాయని లేఖనాలు వివరిస్తున్నాయి   ప్రసంగి
the monitoring committee	పర్యవేక్షణ కమిటీ
celebrations in bengaluru	బెంగళూరు సంబరాల్లో మునిగితేలింది
pawan kalyan started shooting for his movie vakeel saab recently	పవన్ కళ్యాణ్ తాజా చిత్రం పంజాపై రీసెంట్ గా ఓ రూమర్ ప్రారంభమైంది
method preheat the oven to degrees celsius	తయారీ ముందుగా ఓవెన్ను  డిగ్రీల సెల్సియ్సకు వేడి చేయాలి
while taking treatment she dies at hospital	చికిత్స పొందుతుండగా ఆస్పత్రిలోనే తుదిశ్వాస విడిచారు
the mirror in your bedroom	బెడ్ రూమ్ లో అద్దాల
where are the colleges	కోట్లు ఎక్కడివి
making smart choices	స్మార్ట్ ఎంపికలు మేకింగ్
however the brother of the deceased who was being treated in the same ward attacked the doctors	అయితే అదే వార్డులో చికిత్స పొందుతున్న మృతుడి సోదరుడు వైద్యులపై దాడికి పాల్పడ్డాడు
the differences are vital	వాటిలో తేడా అత్యవసరం
crores	కోట్లు అడిగారా
he was not himself	అతనేం సొంతంగా వెళ్లలేదు
the search engines instant answers are open source and are maintained on github where anyone can view the source code	తక్షణ సమాధానం యొక్క సోర్స్ కోడ్ తెరిచి ఉంది మరియు దీనిని ఎవరైనా  లో హోస్ట్ చేస్తారు తద్వారా ఎవరైనా దీన్ని నిర్వహించవచ్చు మరియు సవరించవచ్చు
skin is yellow in colour and smooth	మాంసం పసుపు చర్మం పింక్ ఉంది
he then shot himself	అనంతరం తనని తాను కాల్చుకున్నాడు
chittoor a newlywed woman committed suicide by immolating herself here on friday night at rama samudram chittoor district	రామసముద్రం అగ్రిగోల్డ్ బాధితురాలు గుండెపోటుతో మృతి చెందిన ఘటన చిత్తూరు జిల్లా రామసముద్రం మండలంలో ఆదివారం వెలుగులోకి వచ్చింది
the video has gone viral on various social media platforms	ఈ వీడియో ప్రస్తుతం సోషల్ మీడియాలో వైరల్గా మారింది
im the same	నేనే ఆ శాలీనుణ్ణి
pawan kumar director	అయితే ఈ సందర్భంగా దర్శకుడు పవన్ కుమార్
she attended yashodham high school and completed her preuniversity education at dg	యశోథమ్ ఉన్నత పాఠశాల నుండి చదువుకున్నాడు ఆమె పూర్వవిశ్వవిద్యాలయ విద్యను   రుపరేల్ కళాశాలలో చేసారు
the is your last digit	అంకెలలో  అనే అంకె చివరిది
as many as countries are currently searching the missing plane	కాగా అదృశ్యమైన విమానం గాలింపులో ఇప్పటికే  దేశాలు పాల్గొంటున్నాయి
the eyes glow red	కళ్ళు ఎర్రగా వున్నాయి
social distancing	సామాజిక దూరం
the incident took place in palasa town of srikakulam district	ఈ ఘటన శ్రీకాకుళం జిల్లాలోని పలాసలో చోటు చేసుకొంది
he walked away smiling	ఎగతాళిగా నవ్వుకుంటూ వెళ్ళిపోయాడు
however he died while undergoing treatment for his wound	అయితే పరిస్థితి విషమించడంతో చికిత్సపొందుతూ ఆయన కన్నుమూశారు
i am not worthy	ాకు బతికే అర్హతలేదు
the bjp is yet to make an announcement	బిజెపి ఇంకా ప్రకటించలేదు
many of the orthodox considered translating the scriptures outrageous no matter how obscure the text otherwise might be to readers	కాలీపోలీటిస్ అనువాదాన్ని పూర్తి చేసి ఎంతో కాలం గడవక ముందే మరణించాడు
dr rekha vijayashanti the younger sister of indrani is inspired by surendras good heart and starts loving him	ఇంద్రాణి చెల్లెలు డాక్టర్ రేఖ  విజయశాంతి  సురేంద్ర మంచి హృదయంతో ప్రేరణ పొంది ఆయనను ప్రేమిస్తుంది
east and south east england	పూర్వ్ అనే దక్షిణ పూర్వ్ ఈంగ్లేన్డ్
but im just talking in general	కానీ నేను నేరుగానే మాట్లాడుతున్నా
lakhs yet	లక్షల కోట్లు దాకా ఉంటుంది కదా
wood firing	చెక్క దహనం
just a	వీపునే ఒక
the election marks the second democratic transition of power in pakistans year history	దేశ  ఏళ్ల చరిత్రలో ప్రజాస్వామ్యబద్ధంగా జరుగుతున్న రెండో అధికార బదిలీ ప్రక్రియలో పీటీఐ వైపు ఎక్కువ మంది ఓటర్లు మొగ్గు చూపారు
counsel arb	న్యాయవాది అర్బ్
cut down on clutter	వస్తువుల్ని ఉపయోగించడానికి వాటిని సర్దుకోవడానికి శుభ్రం చేయడానికి భద్రపర్చుకోవడానికి వాటిని చూసుకోవడానికి సమయం పడుతుందని మనందరికీ తెలుసు
as a result a sprain occurs	ఫలితంగా ఒక స్ట్రోక్ వైకల్యాలు ఉంది
must know	అన్నది తెలియాల్సి ఉంది
april	పోలింగ్ ఏప్రిల్
amarnath yatra suspended temporarily	అమర్నాథ్ యాత్ర తాత్కాలికంగా నిలిపివేత
please leave me	నన్ను వదిలేయండి అంటూ తమ్మారెడ్డి పేర్కొన్నారు
its nice to look good	చూడ్డానికి మంచిగా కనిపించాలి
it is a continual burnt offering which was ordained in mount sinai for a pleasant aroma an offering made by fire to yahweh	అది యెహోవాకు ఇంపైన సువాసనగల హోమముగా సీనాయికొండమీద నియమింపబడిన నిత్య మైన దహనబలి
then he transferred rs	అనంతరం అతనికి రూ
the place has contributed enormously to the indian freedom movement as the famous freedom fighter and kisan leader pandit yamuna karjee used to reside here at one point of time	ఈ స్థలం భారత స్వతంత్రోద్యమానికి ఎంతో దోహదపడింది ప్రసిద్ధ స్వాతంత్ర్య సమరయోధుడు రైతు నాయకుడు పండిట్ యమునా కర్జీ ఒకప్పుడు ఆ ప్రాంతంలో ఉన్నారు
presently gujarat governor om prakash kohli holds additional charge as the madhya pradesh governor	అదే విధంగా గుజరాత్ గవర్నర్ ఓ ప్రకాశ్ కోహ్లీకి మధ్యప్రదేశ్ గవర్నర్గా అదనపు బాధ్యతలు అప్పగించింది
who is suraj	ఎవరు సౌర్యా
the metropolitan transit authority of harris county texas or metro provides public transportation in the form of buses trolleys and lift vans	మెట్రోపాలిటన్ అధారిటీ ఆఫ్ హరీస్ కౌన్టీటెక్సాస్ లేక మెట్రో బసులులైట్ ట్రైన్ లిఫ్ట్ వాన్లను నడుపుతూ సేవలందిస్తుంది
list of agreements acknowledged on the occasion of indialuxembourg virtual summit	ఇండియా  లక్సెంబర్గ్ వర్చువల్ శిఖారగ్ర సమ్మేళనం సందర్భంగా ఆమోదించిన ఒప్పందాల జాబితా
lakh crore	కోట్లకు చేరింది
we dont think so	మాకు ఆ ఆలోచనే లేదు
selection process shortlisting personal interactioninterview online examination	ఎంపిక విధానం ప్రిలిమినరీ మెయిన్ ఆన్లైన్ రాతపరీక్షలు గ్రూప్ డిస్కషన్ పర్సనల్ ఇంటర్వ్యూ ద్వారా
no change at all	ఎలాంటి మార్పు లేదు
i slapped him hard	తనని గట్టిగా కౌగిలించుకున్నాను
soft skills	కూల్ నైపుణ్యాలు
the body was taken to osmania hospital for postmortem	మృతదేహాన్ని పోస్టుమార్టం కోసం ఉస్మానియా హాస్పిటల్కి తరలించారు
love just grew between the two	వారిద్దరి మధ్య ప్రేమ అంకురించింది
discussion under rule on air pollution and climate change	నిబంధన  కింద వాయు కాలుష్యం వాతావరణ మార్పులపై చర్చ జరుగుతుంది
dont give up anything	దేన్నీ వదులుకోకూడదు
he reportedly committed suicide by hanging	అత్తింటి వేధింపులతో ఆత్మహత్య చేసుకున్నట్లు పేర్కొన్నారు
a revanth reddy	ఎ రేవంత్ రెడ్డి
the children look so happy	పిల్లలు చూడడానికి ముచ్చటగా ఉన్నారు
jitendra singh commends the yeomen services rendered by civil servants in indias fight against covid on civil services day calling for greater interservice camaraderie citing the successful example of the caruna platform which brings together service associations in an endeavour to support natural disasters dr	కోవిడ్ పై జాతి పోరాటంలో విశేష సేవలందిస్తున్న సివిల్ సర్వెంట్స్ సివిల్ సర్వీసెస్ దినోత్సవం సందర్భంగా డాక్టర్ జితేంద్ర సింగ్ ప్రశంస ప్రకృతి వైపరీత్యాలలో తోడ్పడేందుకు  సర్వీసు అసోసియేషన్లను ఒకచోట చేర్చిన కరుణ వేదిక విజయవంతం కావడాన్ని డాక్టర్ సింగ్ ఉదాహరించారు ఈ మేరకు వారితో దృశ్యశ్రవణ మాధ్యమ సమావేశంలో ముచ్చటించారు
how often do you take breaks	మీరు ఎంత విశ్రాంతి తీసుకోవాలి
how was it done	ఎలా చేస్తారు
the ceremony is likely to be attended by former presidents barack obama george w bush and bill clinton	అమెరికా మాజీ అధ్యక్షుడు ఒబామా జార్జ్ బుష్ బిల్ క్లింటన్ ఈ వేడుకలకు రానుండగా ఎంతో మంది ప్రముఖులు హాజరుకానున్నారు
success and failures are part of life	విజయం పరాజయం జీవితంలో ఓ భాగం
the incident took place in karnataka	కర్ణాటక రాష్ట్రం లో ఈ దారుణ ఘటన చోటుచేసుకుంది
asked the question	అని సవాల్ ప్రశ్నించారు
health is very important	ముక్కలు ఆరోగ్య చాలా ముఖ్యం
no hands	ఖాళీ చేతులతో రాలేదు
then wash off	తర్వాత శుభ్రం చేసుకోండి
look and laugh at allmovie stop	అని భజించాడుగ్రుడ్డి అన్నా
music by sai karthik is good	సాయి కార్తీక్ మ్యూజిక్ బాగుంది
it is the place where it stands	ఆ చోటు ఇదే
the rooms here are cosy and spacious	గదులు విశాలంగా కానీ హాయిగా ఉన్నారు
it is planned to test icemole in the summer of	సీప్  పరీక్ష  మే  న జరిగింది
thousand	వేలు కేటాయించారు
the additional charge	అదనపు వసూళ్ల పర్వం
so i went into films	అలా చిత్ర పరిశ్రమలోకి వచ్చాను
actor pawan kalyan	పవన్ కళ్యాణ్ ఫ్యాక్టర్
prepaid plan	రీఛార్జ్ ప్లాన్
plogging at beach	తీరంలో అలజడి
he asked some questions	అంటూ ఆయన ప్రశ్నలు కురిపించారు
