option can be chosen	ఎంపిక కావచ్చు
titled samajavaragamana sid sriram has crooned the song while by thaman s has composed the music	తమన్ కంపోజిషన్లో సిద్ శ్రీరామ్ ఈ పాటలను పాడగా సిరివెన్నెల సీతారామశాస్త్రి సాహిత్యాన్ని అందించారు
in second world war totally seven million of the german people are died	తూర్పు యూరప్ కి చెందిన స్థానిక జర్మన్ లతో కలిపిసుమారు ఏడు మిలియన్ల మంది జర్మన్ సైనికులురెండవ ప్రపంచయుద్ధంలో మరణించారు
guwahati bhubaneswar kolkata ahmedabad navi mumbai to host the games	షెడ్యూల్ ప్రకారం ప్రపంచకప్ మ్యాచ్లకు కోల్కతా గువాహటి భువనేశ్వర్ అహ్మదాబాద్ నవీ ముంబై నగరాలు ఆతిథ్యమివ్సాల్సింది
the new aadhaar app can be downloaded by bothandroid and ios users	కొత్త ఆధార్ యాప్ ను ఆండ్రాయిడ్ ఐఓఎస్ వినియోగదారులు ఇద్దరూ డౌన్లోడ్ చేసుకోవచ్చు
she has acted in over movies	కెరీర్లో దాదాపు కి పైగా సినిమాల్లో నటించింది
the same question again	మళ్ళీ అదే ప్రశ్న
on eve of congress foundation day rahul gandhi leaves on foreign visit	కాంగ్రెస్ ఆవిర్భావ దినోత్సవ వేళ రాహుల్ విదేశీ పర్యటన టార్గెట్ చేసిన బీజేపీ తరవాత కథనం
so you dont need to deposit the cash	కాబట్టి ఆ మొత్తాన్ని మీరు చెల్లించాల్సిన అవసరం ఉండదు
finding a job	ఒక జాబ్ ఫైండింగ్
flat no	ఫ్లాట్ నెం
as a result most rural areas are dominated by a small set of feudalistic landowning families	ఈ కారణంగా గ్రామీణ ప్రాంతాలు చిన్న స్థాయి భూస్వామ్య కుటుంబాల ఆధిపత్యంలో ఉన్నాయి
republic day celebrations are taking place across the country	దేశవ్యప్తంగా గణతంత్ర దినోత్సవ వేడుకలు జరుగుతున్న సంగతి తెలిసిందే
their sacrifices wont go waste	వారి త్యాగాలు వృథా పోవు
crore rs	కోట్లు అంటే ఏడాదికి రూ
he scored	ఇన్గ్రామ్  పరుగులు చేశాడు
the movie starts off slowly	సినిమా ఓ దృశ్యకావ్యంలా మొదలవుతుంది
but it looks difficult	కానీ అది బోరింగ్ అనిపిస్తుంది
public witnessing is one excellent method of spreading the good news	బహిరంగ సాక్ష్యం ద్వారా మంచి ఫలితాలు పొందాలంటే ఏమి చేయాలి
the representatives shared the problems related to factory shutdown permission to operate warehouses personnel movement and logistic disruption	ఫ్యాక్టరీల మూసివేత గిడ్డంగుల నిర్వహణ సిబ్బంది రాకపోకలకు సరకు రవాణా రాకపోకలకు అంతరాయం వంటి అంశాలను పరిశ్రమ ప్రతినిధులు ప్రస్తావించారు
he expressed displeasure over the behaviour of three mlas in the party	పార్టీలోని ముగ్గురు ఎమ్మెల్యేల తీరు పట్ల ఆయన అసహనం వ్యక్తం చేశారు
batting bowling and fielding	బ్యాటింగ్ బౌలింగ్ ఫీల్డింగ్లో దూసుకెల్తోంది
school calendar	స్కూల్ క్యాలెండర్
i talk of social and political issues	సామాజిక అంశాలు రాజకీయాలు చర్చిస్తారు
some films did not work out	తరువాత కొన్ని సినిమాలు చేసినా అవేవి వర్క్ అవుట్ కాలేదు
sourav ganguly achieved a lot of success as captain of the indian cricket team	భారత మాజీ క్రికెట్ క్రీడాకారుడు సౌరవ్ గంగూలీ టెస్ట్ కెప్టెన్ గా భారత్ కు పలు విజయాలు అందించాడు
tears flood into her eyes	ఆమె కళ్ళల్లో నుండి కన్నీళ్ళు రాలుతున్నాయి
p ispat private limited	జిపిఇస్పాట్ ప్రైవేట్ లిమిటెడ్
i do not work	నేనా పని చేయను
wheres the cooking	తయారీ ఎక్కడ
recently however another problem has surfaced	అయితే తాజాగా మరో ఎఫైర్ వెలుగు చూసింది
everyone lives for himself	అందరిలానే వారూ వారికోసమే బతుకుతున్నారు
his father was a businessman	అతని తండ్రి ఆర్థికంగా పనిచేశారు
yediyurappaled bjp government	ఇక యడ్యూరప్ప నేతృత్వంలోని ప్రభుత్వ ఏర్పాటే తరువాయి
the movie is helmed by siddiqui	ఈ సినిమాకి సిద్ధిఖీ దర్శకత్వం వహించనున్నాడు
others differ	దో తేడాగా ఉందని ఇంకొందరు
axis bank shares rise	శాతం జంప్చేసిన యాక్సిస్ బ్యాంక్ షేరు
why did he cry	ందుకు మనకోసం తను ఏడుస్తుంది
becoming an actress	నటి అవటానికి
her immovable assets amounts to rs	ఈమె సంపద విలువ రూ
density of materials	మెటీరియల్ మందం
mr siva counsel	మిస్టర్ శివ కౌన్సెల్
it shakes me	అని నన్ను వెక్కిరిస్తుంది
but hes a good writer	కానీ ఆయన గొప్ప రచయిత
hearty facts	గుండెలు పిండే నిజాలు
allow us to explain	మాకు వివరించేందుకు లెట్
the question for rs	అంటూ ప్రశ్నించా రు
he can change his stand anytime	అతను ఏ సమయంలో తన నిర్ణయాన్ని మారవచ్చు
new heights	న్యూ హైట్స్
whats the story	కథ ఎటుపోతోంది
the resolution was however defeated by one vote	కానీ కేవలం ఒకే ఒక్క ఓటుతో ఆ ప్రతిపాదన వీగిపోయింది
the news of her sad demise was revealed to the world by her brother rishi kapoors daughter riddhima kapoor	ఈ సందర్భంగా రిషి కపూర్ కూతురు రిధిమా కపూర్ తండ్రి మరణంపై విచారం వ్యక్తం చేశారు
such opportunities are rare	ఇలాంటి అవకాశాలు అరుదుగా వస్తాయి
everyone knows how great he is	ఆయన వ్యక్తిగా ఎంత గొప్పవాడో అందరికీ తెలుసు
attitudes too are changing	లోచనా విధానం కూడా మారుతుంది
low on funds	నిధులు తక్కువగా నడుస్తున్నారా
everything has happened	అన్నీ చకచకా జరిగిపోయాయి
lucky colour beige	లక్కీ కలర్  గోధుమ రంగు
the ornament of all galilee	గలిలయ ప్రాంతానికే తలమానికం
he was not in attendance	దీనికిఅతడు హాజరుకాలేదు
he wrote five novels five short story collections and a novella	ఈయన ఐదు నవలలు ఎనిమిది చిన్న కథలు తొమ్మిది నాన్ ఫిక్షన్ కి సంబంధించిన రచనను రచించారు
only	కేవలం  సార్లు మాత్రమే
then everyone would be happy	అప్పుడు అందరూ ఆనందంగా ఉండవచ్చు
crunch game	క్రాక్ గేమ్
directed by vamshi paidipally maharshi stars mahesh babu and pooja hegde	వంశీ పైడిపెల్లి దర్శకత్వంలో రూపొందిన ఈ సినిమాలో మహేష్ సరసన అందాల భామ పూజా హెగ్డే చిందులేసింది
hes both	ఆయన ఆ రెండూ గనక
but it yielded no result	కానీ అది ఏ మాత్రం ఫలితం ఇవ్వలేదు
crore for the programme	వేల కోట్లు బడ్జెట్ను కేటాయించింది
in short the perfect italian job	ఒక్క ముక్కలో చెప్పాలంటే పర్ఫెక్ట్ ఇటాలియన్ జాబ్
lakhs by mumbai indians	లక్షలు లకు ముంబై దక్కించుకుంది
the maharashtra agricultural lands ceiling on holdings amendment act maharashtra act xiii of	మహారాష్ట్ర వ్యవసాయ భూముల కమతముల గరిష్టపరిమితి సవరణ చట్టము  లోని వ మహారాష్ట్ర చట్టము
recently the centre allotted rs	ఇటీవలే కేంద్రం రూ
id never met him before	నేను ముందు అతనిని కలుసుకున్నారు ఎప్పుడూ
is it really	ఇది నిజంగా   ఈజ్
set to true to disable showing known users in the login window	లాగిన్ విండోనందు తెలిసిన వాడుకరులను చూపుట అచేతనంచేయుటకు సత్యంకు అమర్చుము
rs crore is not peanuts	కోట్లు కాదని అది రూ
riots in hyderabad	హైదరాబాద్లో రౌడీమూకల బరితెగింపు
hes laughing	వ్వుతూ చెబుతున్నాడు
the loan amount is restricted to a maximum of per cent of the balance in your account at the end of the first financial year where in if you opt for rd year	మొదటి ఏడాది చివరన ఖాతాలో ఉన్న మొత్తంలో  శాతం వరకూ మూడో ఏడాది రుణంగా పొందవచ్చు
it formed government in up uttarakhand manipur and goa while in punjab the congress came to power	ఇటీవల జరిగిన ఐదు రాష్ట్రాల ఎన్నికల్లో ఉత్తరప్రదేశ్ మణిపూర్ గోవా ఉత్తరాఖండ్లలో బీజేపీ ప్రభుత్వం ఏర్పాటు చేయగా పంజాబ్లో మాత్రం కాంగ్రెస్ పార్టీ అధికారంలోకి వచ్చింది
theyve done great service for the team	టీమిండియాకు చాలా సేవ చేశా
each individual is different	ఒక్కొక్కరి స్వార్థం ఒక్కోలా ఉంటుంది
the first prototype was developed at brd af and has undergone various modifications	ఈ పెట్టె మొదటి నమూనాను వాయుసేన మూడో బ్రిగేడ్లో తయారు చేశారు
novelist shortstory writer poet	కవి నవలా రచయిత మరియు కథారచయిత
gurupurab wishes to everyone	ప్రతి ఒక్కరికీ గురుపరబ్ శుభకామనలు
since then the case has remained stuck	అప్పటి నుంచి కేసు స్టే మీదే నిలిచిపోయింది
lok sabha speaker sumitra mahajan senior bjp leader lk	లోక్ సభ స్పీకర్ పదవికి భాజపా సీనియర్ నేత సుమిత్రా మహాజన్ నామినేషన్ దాఖలు చేసారు
the positivity rate stands at percent	రిటైలర్ల వాటా  శాతంగా నమోదైంది
ram gopal varma is a happy man	రామ్ గోపాల్ వర్మ ఆనందం మామూలుగా లేదిప్పుడు
a museum is being built too	అలాగే కూడా ఒక మ్యూజియం ఉంది
effect on loans	లోన్పై వీటి ఎఫెక్ట్
why not on political grounds	రాజకీయ ప్రాధాన్యత లేకుండా చేసినందుకా
because its ugly	ఎందుకంటే అది బందీ
double century	డబుల్ సెంచరీ
the body was later shifted to osmania hospital for postmortem	అనంతరం పోస్టుమార్టం నిమిత్తం ఉస్మానియా ఆసుపత్రికి తరలించారు
thoughts about the tata tiago xt variant to recieve new feature updates	టాటా టియాగో ఎక్స్టి వేరియంట్లోని కొత్త ఫీచర్లపై డ్రైవ్స్పార్క్ అభిప్రాయం
the clues team arrived at the scene and collected evidence	క్లూస్ టీమ్ సభ్యులు ఘటనా స్థలానికి చేరుకుని వేలిముద్రలను సేకరించారు
price at rs	త్రివేండ్రంలో ధర రూ
cinematography manikandan	ఛాయాగ్రహణం మణికండన్
in ideal conditions it grows very fast	అనువైన పరిస్థితులలో వృద్ధిరేటు చాలా వేగంగా ఉంటుంది
design and engineering	ఇన్ఫ్రాస్ట్రక్చర్ అండ్ డిజైన్
im deeply grateful to them	వారికి హృదయ పూర్వకంగా కృతజ్ఞతలు తెలియచేస్తున్నా
the poor are becoming poorer	పేదవాడు మరింత పేదరికంలో మగ్గుతున్నాడు
he asked the states to brainstorm and send suggestions for the exit strategy	ఈ నిష్క్రమణ వ్యూహానికి సంబంధించి రాష్ట్రాలు ఆలోచన చేయాలని ప్రధానమంత్రి సూచించారు
superstar mahesh babu is celebrating his birthday and all of social media went viral about the actors birthday	టాలీవుడ్ సూపర్ స్టార్ మహేష్ బాబు పుట్టిన రోజు సందర్భంగా సోషల్ మీడియా మోత మోగిపోతోంది
it is very distressing	చాలా ఇబ్బందిగా ఉంది అని రష్మిక తెలిపింది
thats the movie	అదీ సినిమా
hes played firstclass cricket	ఫస్ట్ క్లాస్ క్రికెట్లో సత్తాచాటుతున్నాడు
pm	రాత్రి గంటలు
online education	అసమ సమాజంలో ఆన్లైన్ విద్య
slick and sexy	సెక్సీ మరియు అధునాతన
catch pics	పొందండి చిత్రాలు
but not everything is as it seems	కానీ అన్నీ అనుకున్నట్లుగా జరగవు కదా
the move however was opposed by the bjp	అయితే బీజేపీ జార్ఖండ్ విభాగం ఈ చర్యను ఖండించింది
and above	ఉంటుంది
batsman who clouted six and fours in his ball knock	వ నంబర్ ఆటగాడు శ్రీనాథ్ అరవింద్  బంతుల్లో   ఫోర్లు ఒక సిక్స్ అర్ధసెంచరీ చేయడం విశేషం
topnotch camera	ఉత్తమ అధునాతన కెమెరా
parents cry foul	గుండెలు పగిలేలా రోదిస్తున్న తల్లిదండ్రులు
during the th and th centuries numerous bridges connected the banks of the thames the most famous being old london bridge	థేమ్స్ నదిని దాటేందుకు   శతాబ్దాల్లో అనేక వంతెనలు నిర్మించబడ్డాయి వాటిలో ఓల్డ్ లండన్ బ్రిడ్జి అత్యంత ప్రఖ్యాతిగాంచింది
i hesitated for a few moments	కొద్ది క్షణాలు తటపటాయించాను
many people do and who today is not affected by injustice crime and violence	చాలామంది అలాంటి స్థితిలోనే ఉన్నారు
leave it alone	వదిలేయండి
is chandrababu scared of bjp	బీజేపీకి సైగ చేస్తున్న చంద్రబాబు
rishabh pant plays a shot	వికెట్ కీపర్గా రిషబ్ పంత్ ఆడతాడు
minute part of the upper time limit	ఎగువ సమయ పరిమితి యొక్క నిముష భాగము
bills amounting to around rs	బిల్లు దాదాపు రూ
ive never met anyone like him	తను అలా ఎవరితోనూ కలవడం నేను చూడలేదు
yet again	మరోమారు
record	రికార్డు
however it was the bjp which is all set to form government in four states except for punjabwhere the congress managed to win seats out of	ఒక్క పంజాబ్ తప్ప మిగిలిన నాలుగు రాష్ట్రాల్లోనూ బీజేపీ హవా స్పష్టంగా కనిపిస్తున్నది
the skin becomes smooth	చర్మం మెరుస్తుంటుంది
nobody has touched it yet	ఇప్పటివరకూ ఈ పాయింట్ని ఎవరూ టచ్ చేయలేదు
t return	తిరిగి రావనుకోవడానికి
the incident took place in the vijayanagar area of bengaluru	శ్రీనగర్ భగత్ బర్జుల్లా ప్రాంతంలో ఈ ఘటన చోటు చేసుకుంది
gujarat punjab and himachal pradesh stood at fourth fifth and sixth spots	గుజరాత్ ఆంధ్రప్రదేశ్ రాజస్థాన్ మూడు నాలుగు ఐదు స్థానాలు పొందాయి
in america the vote is sacred	అమెరికాలో ఓటు చాలా పవిత్రమైంది
tennis roger federer retirement	టెన్నిస్ కు దూరం కానున్న రోజర్ ఫెదరర్
im a daughter of an army officer	నేను ఓ ఆర్మీ అధికారి భార్యను
football is a massive sport all over the world played and watched by millions of fans worldwide	ప్రపంచంలో అత్యధిక ఆదరణ పొందిన క్రీడగా ఉన్న ఫుట్బాట్కు కోట్లాది మంది అభిమానులు ఉన్నారు
how much do you need	నీకు ఎన్ని కావాలి
issued an apology	క్షమాపణలు చెప్పాడు
two children died in the incident	నీటిలో మునిగిన ఇద్దరు పిల్లలు మృతి చెందారు
more information is available in the detailed report	తెలుపబడని వ్యవహార దోషము యెదురైంది
a lot of it	పుష్కలంగా
each entity has its own attributes and distinct qualities	ప్రతి రకం ఒక తప్పనిసరి వేరు దాని స్వంత లక్షణాలు మరియు లక్షణాలను కలిగి ఉంది
the smartphone is powered by the kirin f processor	హైసిలికాన్ కిరిన్ ఏ ప్రాసెసర్పై ఈ స్మార్ట్ ఫోన్ పనిచేయనుంది
the constitutions of pakistan afghanistan and bangladesh provide for a specific state religion	పాకిస్తాన్ అఫ్ఘానిస్తాన్ బంగ్లాదేశ్ల రాజ్యాంగాలు ఒక నిర్దిష్ట రాజ్య మతాన్ని ప్రకటించాయి
enhances communication skills	కమ్యూనికేషన్ నైపుణ్యాలు అభివృద్ధి
not a bit of it is true	ఇందులో కాస్త నిజం లేకపోలేదు
tell the truth to the people	ప్రజలకి వాస్తవాలు చెప్పాలి
but thats not it	కానీ అది కాదా
check out all details	అన్ని వివరాలు పరిగణించండి
theres a number of ways	డమ్మీ అనేక మార్గాలు ఉన్నాయి
thank you ravi bhai	అబ్బూరి రవిగారికి థ్యాంక్స్
the supreme court is expected to deliver the verdict in ram janmabhumibabri masjid title dispute case in the next couple of days	దశాబ్దాల తరబడి సాగుతున్న వివాదాస్పదమైన రామజన్మభూమి  బాబ్రీ మసీదు కేసులో మరి కొన్ని గంటల్లో సుప్రీం కోర్టు తీర్పు చెప్పనుంది
linking of aadhar is not necessary	ఆధార్ లింక్ కూడా చేయక్కర్లేదు
chennai super kings vs delhi capitals csk vs dc	ధోనీ రైనా మెరుపులు  భారీ స్కోరు చేసిన చెన్నై సూపర్ కింగ్స్
prices rise as a result	దీనివల్ల ధరల్లో హెచ్చుతగ్గులు వస్తున్నాయి
has it ever happened	ఇది ఎప్పుడూ జరిగిందా
it is hard to imagine how adam or eve could sin	సంతోషంతో కూడిన నిత్య జీవితం వారిముందు ఉంది
wish you good health and happiness	మీరు ఆయురారోగ్యాలతో సుఖ సంతోషాలతో వర్ధిల్లాలని కోరుకుంటున్నా
ranveer singh played the role of bajirao in the movie	రణ్వీర్ సింగ్ నటించిన బేఫిక్రాలోను కనిపించారు
why so	అలా ఎందుకు అంటే
he later tried committing suicide by drinking poison	అనంతరం వెంట తెచ్చుకున్న పురుగుల మందు తాగి ఆత్మహత్యకు ప్రయత్నించారు
the asiapacific group the	తటస్థ వేదికపై జరిగిన ఆసియా ఓసియానియా గ్రూప్
yahweh spoke to moses saying	అప్పుడు యెహోవా మోషేతో ఇట్లనెనునేను ఇశ్రాయేలీయుల సణుగులను వింటిని
it has a tennis court and basketball ground	టెన్నిస్ మరియు బిలియర్డ్స్ క్రీడా హాల్స్ను పార్క్ ఉంది
some instructions	విధ్యాధరులు
crore	కోట్ల నిధి
change product	ఉత్పత్తిని మార్చండి
lepakshi festivities	ఘనంగా లేపాక్షి ఉత్సవాలు
the imagination is topped by the hindu holy trinity of brahma vishnu and maheshwara	్రిమూర్తులైన బ్రహ్మ విష్ణు మహేశ్వరుడి ప్రతిమలు కనువిందు చేస్తాయి
crore and punjabs rs	కోట్లు రాజీవ్ భీమ కింద రూ
favourite movie	నాకు నచ్చిన సినిమా సీతాకోకచిలక
the restaurant is open only in the evening	ఆన్ సైట్ రెస్టారెంట్ అర్థరాత్రి వరకూ తెరచి ఉంటుంది
so do not push them	కనుక వాటిని తీసుకోకూడదు
dont le	తొందర వద్దు
but it was not implemented till date	కానీ అది ఇప్పటి వరకు ఆచరణ సాధ్యం కాలేదు
the final straw was the governments appointment of s gurumurthy to the rbi board	ఆర్బీఐ బోర్డులో ఎస్ గురుమూర్తిని ఇటీవల ప్రభుత్వం నియమించింది
five thousand crore	ఐదువేల కోట్లు శఠగోపం పెట్టేశారు
malvika sharma is seen playing the leading lady alongside ravi teja	రవితేజ సరసన మాళ్వికా శర్మ హీరోయిన్గా నటించారు
deer lake	డీర్ చెరువు
most farmers are in debts	అధిక భాగం రైతుల్లోనూ నిస్తేజం ఆవహిస్తోంది
he had lost election	గత  ఎన్నికల్లో ఆమె రెండోస్థానంలో నిలిచారు
post name assistant engineer	పోస్టు పేరు జూనియర్ సైంటిఫిక్ ఆఫీసర్ అసిస్టెంట్ అడ్వైజర్
sbi life buy	ఎస్బీఐ లైఫ్ ఇన్సూరెన్స్  టార్గెట్ రూ
do not go to crowded places	రద్దీ ఎక్కువగా ఉన్న ప్రదేశాల్లో ఉండకూడదు
cobalt oxide nanoparticles sigmaaldrich product page lide david r ed	కోబాల్ట్ ఆక్సైడ్ నానోపార్టికల్స్
another person who suffered greatly was a man named steve	స్టీవ్ అనే అతను కూడా చాలా దెబ్బతిన్నాడు
the meeting took place in the bjp head office in delhi	ఢిల్లీలోని బీజేపీ కేంద్ర కార్యాలయంలో ఈ చేరికల కార్యక్రమం జరిగింది
district kabirdham cg	జిల్లా కబీర్ధం సిజి
valentines day special	వాలెంటైన్స్ డే స్పెషల్ కపుల్స్
thus yoga has plenty of possibilities to open the avenues of employment world over	ప్రపంచవ్యాప్తంగా యోగాలో పుష్కలమైన ఉద్యోగావకాశాలు రానున్నాయి
why did you decide to enter politics	అసలెందుకు పాలిటిక్స్లోకి రావాలనుకున్నారు
it is still in service	ఇంకా సర్వీసులో ఉంది
pakistan releases video of downed iaf pilot	పాక్ చెరలో ఉన్న భారత పైలట్ ఇతడేనంటూ వీడియోలు పోస్ట్
the storyline is simple yet believable	స్టోరీ లైన్ సింపుల్ గా ఉన్నా ఆసక్తికరంగా ఉంది
the condition of both are critical according to the doctors	ఇద్దరి పరిస్థితి విషమంగానే ఉన్నట్లు వైద్యులు తెలిపారు
metro man sreedharan requests pm not to agree to delhi govts free travel scheme for women	ఢిల్లీ మెట్రో రైళ్లలో మహిళలకు ఉచితం ప్రయాణం ప్రతిపాదనను ఒప్పుకోవద్దు ప్రధానికి లేఖ రాసిన మెట్రో రూపకర్త శ్రీధరన్
goa cm manohar parrikar passes away	గోవా సీఎం మనోహర్ పారికర్ కన్నుమూత
the five persons travelling the car died on the spot	కారులో ఉన్న ఐదుగురు వ్యక్తులు అక్కడికక్కడే మృతి
healthy skin and hair	చర్మం జుట్టు ఆరోగ్యంగా ఉంటాయి
trs gets majority in telangana assembly elections	తెలంగాణ అసెంబ్లీ ఎన్నికల ఫలితాల్లో టీఆర్ఎస్ పార్టీ స్పష్టమైన మెజార్టీతో దూసుకుపోతుంది
i met him frequently	ఆయ నను తరచుగా కలిసేవాడిని
he was a student leader and was elected as president of delhi university students union	ఢిల్లీ వర్సిటీలో ఉండగానే అఖిల భారతీయ విద్యార్థి పరిషత్ నేతగా ఎదిగారు
bollywood or mollywood	బాలీవుడ్లోనా మాలీవుడ్లోనా టాలీవుడ్లోనా
she has husband and two children	పవన్కుమార్కు భార్య రెండేళ్ల కుమారుడు ఉన్నారు
bring tea immediately	టీ వెంటనే తీసుకురా
onions chopped	ఉల్లిపాయలు  చిన్న ముక్కలుగా తరిగినవి
biquadfilternode channel count changes may produce audio glitches	ఛానల్ లెక్కింపు మార్పులు ఆడియో అవాంతరాలు ఉత్పత్తి చేయవచ్చు
workers to protest	ప్రతిఘటిస్తున్న కార్మికులు
everyones problem	అందరి సమస్య
following the inauguration ceremony joe biden has officially become the th president of the united states	వాషింగ్టన్ అమెరికాకు వ అధ్యక్షుడిగా బాధ్యతలు స్వీకరించిన జో బైడెన్ ప్రమాణ స్వీకార కార్యక్రమానికి ముందే తన యంత్రాంగాన్ని సిద్ధం చేసుకున్నారు
and a fight it was	మరియు ఒక గొప్ప యుద్ధం ఉంది
whos in it	అందులో ఉన్నది ఎవరు
huge traffic jam in hyderabad	హైదరాబాద్ మహా నగరంలో భారీగా నిలిచిన ట్రాఫిక్
its another step	ఇదొక మరో కొత్త అడుగు
here are things to keep in mind	ఇక్కడ గుర్తుంచుకోవాల్సిన విషయాలు ఏంటంటే
teaser which was released recently has garnered tremendous response	తాజాగా విడుదలైన టీజర్కు మంచి రెస్పాన్స్ వచ్చింది
on the third day of navratri the chandraghanta form of goddess durga is worshipped	నవరాత్రి వేడుకల్లో మూడోరోజు అమ్మవారు చంద్రఘంటాదేవి అవతారంలో దర్శనమిస్తుంది ఘంట ఆకారంలో ఉన్న అర్థ చంద్రుని శిరస్సున ధరించి ఉంటుంది తేజోవంతమైన ముఖవర్చస్సుతో ఎంతో గంభీరంగా దర్శనమిచ్చే చంద్రఘంటాదేవి అవతారపు పరమార్థం దుష్టుల్ని అణచి వేయటమే దుష్టసంహారానికి పలు ఆయుధాలతో సిద్దమైనట్లు కనిపించే ఈ తల్లి ఉపాసకులకు మాత్రం ఎంతో సౌమ్యముగానూ దర్శనమిస్తుంది అమ్మ కృప చేత మానవులు పాప విముక్తులవుతారు చక్కని ఆయురారోగ్యాలను పేరు ప్రఖ్యాతులను వీరత్వాన్ని పొందుతారుసకల భూతప్రేతాది బాధలు తొలగిపోతాయి పరాజయం భయం అజ్ఞానం దరిజేరవు
ncp chief sharad pawar cpm general secretary sitaram yechury and cpis s sudhakar reddy attended the meeting	సీపీఎం జాతీయ ప్రధాన కార్యదర్శి సీతారాం ఏచూరి సీపీఐ జాతీయ ప్రధాన కార్యదర్శి సురవరం సుధాకర్రెడ్డి ఆమ్ ఆద్మీ పార్టీ అధ్యక్షుడు కేజ్రీవాల్ మాత్రమే హాజరయ్యారు
nobody listens to anybody	ఎవరూ ఎవరి మాటా వినే పరిస్థితి లేదు
ambani house	అవంబావి ఇల్లు
the incident took place in karimnagar town of telangana	కరీంనగర్ జిల్లా కాతాళం మండలం ధామరకుంటలో ఈ ఘటన చోటుచేసుకుంది
in hyderabad	ైదరాబాద్ లోనే ఉంటా
can you win	మళ్లీ గెలవగలరా
you are leaving	రాఘవా మరి వెళ్ళవా
the bsiv compliant engine comes paired to a speed gearbox and features the is technology	బిఎస్ కాలుష్య నియమాలకు విలువనిస్తూ ఇందులో స్పీడ్ మ్యాన్యువల్ ట్రాన్స్మిషన్ గల గేర్బాక్స్ను అనుసంధానం చేశారు
the population of mali is million	ఈ ద్వీప జనాభా  మిలియన్ల మంది ఉన్నారు
ramakanta has four sons and a daughter	రామయ్యకు భార్య నలుగురు సంతానం ఉన్నారు
risk factors and causes of ovarian cancer	వృషణ క్యాన్సర్కు కారణాలు మరియు ప్రమాద కారకాలు
you can try out some other options too	కొన్ని ఎంపికలు మీరు ప్రయత్నించవచ్చు
dont be shy	అట్టా పిలవమాకండి
a challenging city	సవాలుగా ఉన్న నగరం
it helps to remove toxins in the body	అదే సమయంలో శరీరంలోని టాక్సిన్స్ ను తొలగించడానికి సహాయపడుతుంది
still i enjoyed many blessings	అయినా నేను ఎన్నో ఆశీర్వాదాలు పొందాను
these rapidly displace large water volumes as energy transfers to the water at a rate faster than the water can absorb	ఈ దృగ్విషయం ఒకేసారి చాలా నీటిని స్థానభ్రంసం చెందించి పడుతున్న వ్యర్థాల నుండి శక్తి లేదా వ్యాకోచము నీటిలోకి పరివర్తన చెంది వ్యర్థాలు సముద్రం వాటిని పీల్చుకొనే శక్తికంటే త్వరగా పడతాయి
sindhuraja succeeded his brother munja as the paramara king	సింధురాజా తన సోదరుడు ముంజా తరువాత పరామరా రాజుగా వచ్చాడు
it makes no impact on result	దీని ద్వారా రాబడిపై ఎటువంటి ప్రభావం ఉండదు
andhra pradesh government rubbished the report of south korean automobile giant kia motors moving its plant out of andhra pradesh	కియా మోటార్స్ కార్ల పరిశ్రమ ఆంధ్రప్రదేశ్ నుంచి తరలిపోతుందన్న ప్రచారాన్ని ఖండించిది దక్షిణ కొరియా ప్రభుత్వ అత్యున్నత వాణిజ్య విభాగం
common injuries	సాధారణ గాయాలు
we dont shoot in the dark	మాకు చీకటితో పనిలేదు
why would i lie	నన్నే ఎందుకు మోసం చేస్తున్నారు
the movie is being produced in bollywood	ఇప్పుడు బాలీవుడ్లోనే ఓ సినిమా చేస్తున్నారు
where to start	ఎక్కడి నుంచి మొదలుపెట్టాలి
recently rs	ఇటీవల తన కుమారుడి అకౌంట్ నుంచి రూ
crores	కోట్లకు చేరింది
tdp activist hacked to death	పల్లెలో టీడీపీ కార్యకర్త ఆత్మహత్య
at am on december the earth quaked five miles km south of the city of bam in iran	డిసెంబరు  ఉదయం    గంటలకు ఇరాన్లోని బామ్ పట్టణానికి దక్షిణాన ఎనిమిది కిలోమీటర్ల దూరంలో భూమి కంపించింది
f rs	లైసెన్స్ లేకుండా డ్రైవింగ్ చేస్తే రూ
well almost anything	అవును దాదాపు ఏదైనా
for farmers rs	రైతుకు పంట పెట్టుబడిని ఎకరానికి రూ
because we dont need it	ఎందుకంటే దాంతో మనకు అవసరం లేదు కనుక
how does it compare to other states	ఎపితో ఇతర రాష్ట్రాలను ఎలా పోల్చుతారు
such a system needed to be changed	ఇలాంటి వ్యవస్థ మారాలి
pick a name	క్రొత్త పేరుని ఎంచుకోండి
former australian cricketer dean jones passes away after suffering ma	ఆస్ట్రేలియా మాజీ క్రికెటర్ డీన్ జోన్స్ ఆకస్మిక మరణం
its no different in bollywood	బాలీవుడ్లో చేయకడదనేం లేదు
places names outwood	వీటిని నో లోడ్ ఫండ్స్ అంటారు
most of them are muslims	వారిలో ముస్లింలూ ఎక్కువగానే ఉన్నారు
kcr is the cm	అని సీఎం కేసీఆర్ చెప్పారు
celebrity concern	సినీ ప్రముఖులు ఆందోళన
mr justice pp bhatt president itat presided over the function	ట్రిబ్యునల్ అధ్యక్షుడు జస్టిస్ శ్రీ పిపి భట్ సమావేశానికి అధ్యక్షత వహించారు
all opposition parties are coming together to stop bjp	బిజెపికి వ్యతిరేకంగా ప్రతిపక్ష పార్టీలన్నీ ఏకమయ్యాయి
it is ready to start building at chosen site	చిత్రాలను ఖాళీ స్థలాన్ని పూరించే అనుకూల వాల్యూమ్ను రూపొందించడానికి ఉద్దేశించినవి
world book day is being organised by the unesco since	సంవత్సరంనుండి ప్రపంచ పుస్తక దినోత్సవంను జరుపుతున్నారు
ways to reduce stress	ఒత్తిడి తగ్గింపు పద్ధతులు
about the protest	ప్రతిఘటన గురించి
environmental disaster	పర్యావరణ సంక్షోభం
however he did not budge	అయినా తను కరుణించలేదు
it is only some ha in area	అందులో  కవితా సంకలనాలు కూడా ఉన్నాయి
congress slams the bjp government	కాంగ్రెస్ ప్రభుత్వంపై భాజపా విమర్శలకు దిగింది
add in tomatoes coriander mint and curd and mix well	టొమాటో పచ్చిమిర్చి అల్లం ముక్కలు జీడిపప్పు మిక్సీలో వేసి మెత్తగా రుబ్బాలి
syngene international	సింజీన్ ఇంటర్నేషనల్
member name official website nongovt web portal of jajpur district	అధికారిక వెబ్సైట్
on invisible	కనిపించకుండా
the three excluded ministers are nanu vanani jayanti kavadiya and vallabh vagahsia	ఆ ముగ్గురే మంత్రి కొడాలి నాని వల్లభనేని వంశీ వంగవీటి రాధా
high road fatalities	రోడ్డు ప్రమాదాల్లోనే ఎక్కువ మరణాలు
in proportion	నిష్పత్తిలో
a total of motors are being set up in pump houses under kaleshwaram project	కాళేశ్వరం ప్రాజెక్టు మొత్తంలో  పంపింగ్ స్టేషన్లు  పంపులు పనిచేస్తాయి
shankarehsaanloy are going to score the music and madhie is the cinematographer	ఈ మూవీ కి శంకర్  ఎహసాన్ లాయ్ సంగీతం అందిస్తుండగా  సినిమా ఫోటో గ్రాఫర్ గా మది వర్క్ చేయబోతున్నాడు
follow the doctors advice	డాక్టర్ల సూచనలు పాటించండి
fire teams reached the spot immediately after receiving the information	సమాచారం అందుకున్న సహాయక బృందాలు వెంటనే రంగంలోకి దిగాయి
mtnl bsnl state government	బిఎస్ఎన్ఎల్ఎంటిఎన్ఎల్కు ప్రభుత్వం అండ
hcl technologies buy	హెచ్సీఎల్ టెక్నాలజీస్  ప్రస్తుత ధర రూ
the deceased include two women and two children	మృతుల్లో ఏడుగురు మహిళలు ఇద్దరు పిల్లలు ఉన్నారు
cm kcr in tough spot	సీఎం కేసీఆర్ దిగ్బ్రాంతి
its not wrong	తప్పు కాదు
the officials informed the matter to the district authorities	స్థానికులు జలమండలి అధికారులకు సమాచారం ఇచ్చారు
no disappointment	నిరాశ కనపడనీయరు
its several times higher	ఇది ఎన్నో రెట్లు పెరిగింది
the situation is getting increasingly worse	దీంతో పరిస్థితి మరింత తీవ్రంగా మారుతోంది
store the liquid in a cool place	చల్లని ప్రదేశంలో పానీయం ఉంచండి
who is my mother	ిమ తల్లి ఎవరు
or not	లేదా లేదు
things needed to make the decoction	పానీయం తయారీకి అవసరమైనది
resume compositing	కంపోజిటింగ్ రకము
but he didnt come back home	కానీ ఇంటికి తిరిగి సజీవంగా రాలేదు
another chance to get registered	ఓటరుగా నమోదుకు మరో ఛాన్స్
he must think quickly	మీరు త్వరగా ఆలోచించాలి
suggestion	ప్రతిపాదన
but no one is dying	కానీ ఈ ఎవరైనా చనిపోతాయి అని కాదు
the bjp responded sharply	దీనిపై బీజేపీ తీవ్రంగా స్పందించింది
hes not fat	అతను భారీ కాదు
about children participated	మంది పిల్లలకు భోజనం వడ్డించారు
yes it did	అవును చేసిందట
the objective was to avoid repressing their development	వారి అభివృద్ధిని అణగార్చకూడదనేదే దాని ఉద్దేశం
maharashtra has the highest amount of tax on petrol	అత్యధిక వ్యాట్ విధిస్తున్నదీ మహారాష్ట్రలోనే
improve focus and concentration	దృష్టి ఏకాగ్రతను మెరుగుపడేట్లు చేస్తుంది
nobel prize in science	నోబెల్ బహుమతి
karnataka a meeting of congress leaders is underway in bengaluru	బెంగళూరు కర్నాటక బిజెపి నేతలు షాంగ్రిల్లా హోటల్లో సమావేశమయ్యారు
how big is it	ఎంత పెద్దగా ఉన్నాయి
in the southern united states pickled okra and watermelon rind are popular as are deepfried pickles and pickled pigs feet pickled chicken eggs pickled quail eggs pickled garden vegetables and pickled sausage	దక్షిణ యునైటెడ్ స్టేట్స్లో ఊరవేసిన ఓక్రా మరియు పుచ్చకాయ ముక్కలు ఆదరణ కలిగినవిగా ఉంటున్నాయి బాగా వేయించిన ఊరగాయలు మరియు ఊరవేసిన పంది కాలు లిప్ప్ చికెన్ గుడ్లు క్వీల్ పక్షి గుడ్లు మరియు ఊరవేసిన సాసేజ్ల రూపంలో ఇవి అందుబాటులో ఉంటున్నాయి
the bjp is strong here	ఇక్కడ వైసీపీ బలంగానే ఉంది
but it looks like	కానీ చూసేసారే
a large number of party workers locals attended the party	ఈ కార్యక్రమంలో పెద్ద ఎత్తున పార్టీ శ్రేణులు స్థానిక ప్రజలు పాల్గొన్నారు
soon officials of fire and emergency department reached the spot and pressed fire tenders to control the fire	సమాచారం అందిన వెంటనే అగ్నిమాపక సిబ్బంది అక్కడకు చేరుకుని  ఫైరింజన్లతో మంటల అదుపు చేశారు
crore	కోట్లను ఇన్వెస్ట్చేయగా డీఐఐలు రూ
the bharatiya janata party opposed the resolution	ఈ నిర్ణయాన్ని భారతీయ జనతా పార్టీ వ్యతిరేకించింది
registration is free	మరియు నమోదు ఉచిత ఉంది
it is still not clear how she contracted the virus	దీంతో ఆమెకు వైరస్ ఎలా సోకిందో అంతుపట్టడం లేదు
green chilli finely chopped	పచ్చిమిర్చి  సన్నగా తరిగినవి
save and quit	దాయుము మరియు నిష్క్రమించు
it went on to become a best seller	ఇది ఒక బెస్ట్ సెల్లర్ మారింది
it isnt so easy	అంత ఈజీగా నమ్మలేం
crores respectively	కోట్లు
the song is written by shreemani and sung by simha priya himesh	ఇక రామ లప్స్ సీత పాటను శ్రీమణి రాయగా సింగర్స్ సింహ ప్రియా హిమేష్ పాడారు
herodotus of halicarnassus bcc	చరిత్రకారుడు హెరోడోటుస్
the government is committed to doubling the income of farmers by	నాటికి రైతుల ఆదాయాన్ని రెట్టింపు చేయడమే సర్కారు లక్ష్యం
cup laphet paste	కప్పు తురిమిన చీజ్
the decision to be together	కలిసి నిర్ణయించుకునేలా
i dont believe anybody knows	నాకు నమ్మకం ఎవరూ గమనించే
mla held on murder charge	హత్య కేసులో లొంగిపోయిన ఎమ్మెల్యే
he was accompanied by up cm yogi adityanath bihar deputy cm sushil modi and uttarakhand cm trivendra singh rawat at the atal ghat as well as in the meeting	ఈ బోటు షికారులో యూపీ సీఎం యోగి ఆదత్యనాథ్ తోపాటు ఉత్తరాఖండ్ సీఎం త్రివేంద్ర సింగ్ రావత్ బీహార్ డిప్యూటీ సీఎం సుశీల్ మోడీ ప్రధాని వెంట ఉన్నారు
several bollywood personalities expressed shock and grief over her death	ఆమె మృతిపట్ల బాలీవుడ్ సినీ ప్రముఖులు దిగ్భ్రాంతి వ్యక్తం చేశారు
i just loved a wild drunkard	ఒక బ్రాహ్మణ కన్య చాకలివాడ్ని ప్రేమించడమా
nayak and others participated	నాయక్ తదితరులు ఈ కార్యక్రమంలో పాల్గొన్నారు
it inspired art music films sport	సంగీతం క్రీడలు సినిమాలు రచనలు వంటి ప్రధాన రంగాలను సైతం ప్రభావితం చేశారన్నారు
five killed in us shooting	అమెరికాలో కాల్పులు ఐదుగురు మృతి
men not allowed	మగవారికి ప్రవేశం లేదు
rashid khan afghanistan vs west indies	రషీద్ ఖాన్ ఆప్ఘనిస్థాన్    వెస్టిండిస్
doggy khayenge to kya hoga	కోతి కొమ్మచ్చి ఆడదామా
the test comprises three parts	పరీక్ష మూడు విభాగాలుగా ఉంటుంది
shares and securities	షేర్లు సెక్యూరిటీలు
these cause inconvenience to commuters and passengers	దీంతో ప్రయాణికులు ప్రజలు ఇబ్బందులు పడుతున్నారు
when i came to know jehovah i was helped to quit those habits	నేను యెహోవాను తెలుసుకున్నప్పుడు ఆ అలవాట్లను మానుకోవడానికి నాకు సహాయం లభించింది
best actor male shahid kapoor haider	ఉత్తమనటుడు షాహిద్ కపూర్ ఉత్తమ నటి ఆలియాభట్
javari temple is a unique presentation of the khajuraho tourism	ఖజురహో పర్యటనలో జవారి దేవాలయం చాలా ఆకర్షనీయమైనది
no discussions at present	ఇప్పట్లో చర్చలు లేవు
it is bordered by telangana to the west chhattisgarh to the north odisha to the northeast tamil nadu to the south karnataka to the west and the bay of bengal to the east	దీనికి వాయువ్యంగా తెలంగాణ ఉత్తరాన ఛత్తీస్గఢ్  ఈశాన్యంలో ఒడిషా దక్షిణాన తమిళనాడు పశ్చిమాన కర్ణాటక తూర్పున బంగాళాఖాతంఉన్నాయి
the situation is more serious at the government hospitals	పెద్దనగ రాల్లోని ప్రభుత్వ ఆస్పత్రుల పరిస్థితి మరింత దయనీయంగా ఉంది
other reasons can be hereditary	ఇతర కారణాలుగా వృద్దాప్యం మరియు డయాబెటిస్కు సంబంధించిన కుటుంబం చరిత్రలను చెప్తారు
star wars and peace	యుద్ధాలు మరియు శాంతి సన్నిధి
he runs many educational institutions	పలు విద్యాసంస్థల నిర్వాహకురాలిగా ఉన్నారు
burnley vs bournemouth december pm ist	బర్న్ లీ వర్సెస్ బౌర్నెమౌథ్ డిసెంబర్  సాయంత్రం  గంటలకు
it is being misused by some people	దీన్ని కొంత మంది దుర్వినియోగం చేస్తున్నట్లు తెలుస్తోంది
realistically to root out such habits and to put on the new personality takes concerted effort	వాస్తవికంగా అలాంటి దురలవాట్లను మానుకోవడానికి నవీనస్వభావమును  ధరించడానికి గట్టిగా కృషిసల్పాల్సి ఉంటుంది
we want the guilty to be punished	నిందితులకు ఉరిశిక్షనే మేం కోరుకున్నాం
if you dont get the ball over the goal line it doesnt mean enough	బాల్ని గోల్ లైనులోకి తీసుకెళ్లకపోతే అది సరిపోదని అర్థం అని వ్యాఖ్యానించారు
but the farmers dont care	కానీ రైతులు క్లెయిమ్ చేసుకోవడానికి లేదు
jehovah became the closest person to me and he is still my closest friend	యెహోవా నాకు అత్యంత సన్నిహిత వ్యక్తి అయ్యాడు ఆయనిప్పటికీ అత్యంత సన్నిహిత స్నేహితుడే  అని అంటున్నాడు
dont overheat	మరీ వేడి చేయకండి
the tdp has quit	టీడీపీని చీల్చారు
new dangers	కొత్త ముప్పులు
becoming less active	తక్కువ చురుకుగా ఉండటం
are you for real	ఎమిటీ ఇది నిజమా
according to the group pm modi is preparing his people for a future war against muslims	ఐసిస్ ప్రకారం  మోడీ ముస్లీంల పైన యుద్ధానికి తమ వర్గాన్ని సిద్ధం చేస్తున్నారు
suspension and braking	సస్పెన్షన్ అండ్ బ్రేకింగ్
honda has unveiled its new rebel cruiser motorcycle for the global markets	జపాన్ కేంద్రంగా పనిచేస్తున్న ద్విచక్ర వాహనాల తయారీ సంస్థ హోండా మోటార్సైకిల్ తన కొత్త రెబెల్  బైక్ను ఆవిష్కరించింది
types of psoriasis	సోరియాసిస్ రకాలు
low contrast theme	తక్కువ వ్యత్యాస థీము
the result is utter confusion	ఫలితంగా పూర్తి నిరాశ ఉంది
it was handed over to forest department officials	సంతగల్ అటవీ అధికారులకు అప్పగించారు
the ties are strong	ఆస్థిపాస్తులు గట్టిగా ఉన్నాయి
tdp leaders attacked ysr congress party leaders	ఈ విషయమై టీడీపీ నాయకులు వైఎస్ఆర్సీపీ నేతలతో గొడవకు దిగారు
by friends	స్నేహితులతో
add a little water if required	అవసరం అనుకొంటే కొద్దిగా నీరు పోసుకోచ్చు
i am surprised	నేను ఆశ్చర్యానికి
the school was a bad place	బడి నరకప్రాయంగా ఉండేది
nothing was heard nor uttered	చూడండి లేదా వినడానికి ఏదీ లేదు
so far its good	ఇంతవరకూ బాగానే వుంది
currently allu arjun is acting in a movie under the direction of sukumar	ఇక అల్లు అర్జున్ సుకుమార్ తెరకెక్కిస్తున్న పుష్ప సినిమాలో నటిస్తున్నాడు
volkschule was able to return to the school building	ప్రాథమిక పాఠశాల భవనం ఏర్పాటు చేశారు
thats the heaven on earth	ఇది దేవలోకపు స్వర్గం
ap cm ys jagan to pay tributes at ysr ghat	వైఎస్సార్కు ఘన నివాళులు అర్పించిన ఏపీ సీఎం వైఎస్ జగన్
vijay deverakonda became a big name actor after his massive success in arjun reddy	అర్జున్ రెడ్డి గీత గోవిందం చిత్రాల సూపర్ సక్సెస్ తరువాత విజయ్ దేవరకొండ క్రేజీ హీరోగా మారిపోయాడు
bangalore university ba llb	సీఎంఆర్ యూనివర్సిటీ బెంగళూరు
dont go away	వెళ్లకండి అని చెప్పింది
measuring inflation expectations	ద్రవ్యోల్బణ అంచనాలను అసెస్మెంట్
seeing it all	ఇవన్నీ వూహించేవుంటారామె
kids got it huh	కిడ్ అది సంపాదించి హుహ్
fined rs	జరిమానా వసూలు చేస్తారు
however it doesnt get any mechanical changes	అయితే మెకానికల్ గా ఎలాంటి మార్పులూ చేయలేదు
hyderabad an appalling incident happened in the pedapalli district situated in hyderabad	హైదరాబాద్  నగరంలోని బేగంపేట ప్రాంతంలో దారుణం చోటు చేసుకుంది
so i got admitted to the hospital	అందుకని ఆస్పత్రిలో చేరాను
the day started out warm but at sunset the temperature dropped rapidly	క్యుటాలో సునామీ చాలా బలముగా ఉన్నది కానీ మెడిటేరియన్ సముద్రములో అది త్వరగా తగ్గిపోయింది
featured complete themes	విశేష పూర్తి అలంకారాలు
read sonia gandhi manmohan singh at tihar to meet pc	చదవండి  చిదంబరాన్ని కలిసిన సోనియా మన్మోహన్
later on he was seen in various films	ఆ తర్వాత ఈ మధ్యనే ఒకటీ అర సినిమాల్లో ఆయన కనిపించాడు
the three are	వారు ముగ్గురే ఉన్నారు
he died during treatment at the hospital	ఆ హాస్పిటల్లో చికిత్స పొందుతు మరణించాడు
the kapil devled cricket advisory committee cac named ravi shastri again as the new head coach of the indian cricket team	కపిల్దేవ్ నేతృత్వంలోని క్రికెట్ సలహా కమిటీ టీమిండియా ప్రధాన కోచ్గా రవిశాస్త్రిని తిరిగి నియమించారు
list of actions	చర్యలు జాబితా
tamil cinemas supermoststar rajinikanth has finally announced his entry into politics	తమిళ సినీనటుడు సూపర్ స్టార్ రజినీకాంత్ ఇటీవలే రాజకీయ తెరంగేట్రం చేశారు
crore used to be allotted	కోట్లు మంజూరు చేసిందన్నారు
its not a positive	ఇది సానుకూల పాత్ర లేదు
we are working on developing a national gas grid	జాతీయ గ్యాస్ గ్రిడ్ ను ఏర్పాటు చేసుకోవడానికి కసరత్తు చేస్తున్నాం
its very much a communication tool	ఈ అంత అవసరం కమ్యూనికేషన్ పరికరం
mr bharinath rao	శ్రీ బిహరీనాథ్ రావు
good news for the people looking out for government jobs	ప్రభుత్వ ఉద్యోగం కోసం చూస్తున్న నిరుద్యోగులకు గుడ్న్యూస్
get the new nightly	కొత్త నైట్లీని పొందండి
how are judges chosen	రాజధానుల ఎంపిక ఎలా జరుగుతుంది
polavaram project works	పాలమూరు ప్రాజెక్టులు
respectively	లకు లభించనున్నది
of the half tribe of manasseh in gilead iddo the son of zechariah of benjamin jaasiel the son of abner	గిలాదులోనున్న మనష్షే అర్ధగోత్రపువారికి జెకర్యా కుమారుడైన ఇద్దో అధిపతిగా ఉండెను బెన్యామీనీయులకు అబ్నేరు కుమారుడైన యహశీయేలు అధిపతిగా ఉండెను
thats not true at all	అది ఎంత మాత్రమూ నిజం కాదు
the mill produces a peak power output of ps	ఈ ఇంజన్ గరిష్టంగా  పిఎస్ల శక్తిని ఉత్పత్తి చేస్తుంది
his health condition is stable	అతని ఆరోగ్య పరిస్థితి నిలకడగానే ఉందన్నారు
vehicles stayed off the road	దీంతో రహదారిపై వాహనాలు నిలిచిపోయి
ski resorts	స్కీ రిసార్ట్లు
its a great experience	ఇదొక చక్కని అనుభవం
its not going to be quick	ఇది వేగవంతం లేదు
theres still time for ipl	ఐపీఎల్కు ఇంకా ఎంతో సమయం ఉంది
the rear indicators and the number plate appear to hang just above the rear wheel	వెనుకవైపు ఉండే టర్నింగ్ ఇండికేటర్లు మరియు నెంబర్ ప్లేట్ను పాత వేరియంట్ కన్నా కాస్తంత పైభాగంలో ఉండేలా అమర్చారు
tdp chief chandrababu naidu	అని తెదేపా అధినేత చంద్రబాబునాయుడు మండిపడ్డారు
then rinse them well and dab dry	అప్పుడు వారు మంచిగా ప్రక్షాళన చేయాలి మరియు ఎండిన
however the court had dismissed the plea	అయితే జగన్ పిటీషన్ ను కోర్టు కొట్టేసింది
take immediate action	వెంటనే చర్యలకు ఉపక్రమించండి
the material includes	పదార్థం క్రింది పదార్థాల నుంచి తయారు చేస్తారు
bodies recovered at a house in delhi s burari	ఢిల్లీలో ఒకే ఇంట్లో  మంది మృతదేహాలు వెలుగు చూసిన విషయం తెలిసిందే
best playback singer female meghna mishra main kaun hoon secret superstar	ఉత్తమ గాయని మేఘనా మిశ్రా నచిది ఫిరా  సీక్రెట్ సూపర్స్టార్
sugarcane and coffee are the most important agricultural crops	కాఫీ చెరుకు ఇక్కడి ప్రధాన వాణిజ్య పంటలు
security forces put up a lot of efforts	భద్రతాసిబ్బంది ముమ్మరంగా గాలింపు చర్యలు చేపట్టింది
our aim is social justice	మన లక్ష్యం సామాజిక న్యాయం
at rs	మరియు రూ
a total price money of rs	గ్రా వెండి బిళ్లలు కలిపి మొత్తం విలువ రూ
a person was killed and another injured in the incident	ఈ ఘటనలో ఒకరు మృతి చెందగా మరొకరికి తీవ్ర గాయాలయ్యాయి
vamsi pacchipulusu is cranking the camera while vishal chandrasekhar is composing the music	విశాల్ చంద్రశేఖర్ ఈ సినిమాకు సంగీత అందిస్తుండగా వంశీ పచ్చి పులుసు సినిమాటోగ్రఫీ చేస్తున్నారు
upendra and nayantara starred in the movie as lead actors	నయనతార మరియు ప్రణీతలు హీరోయిన్స్గా నటించారు
however the authorities are yet to take any steps	అయినప్పటికీ చర్యలు తీసుకునేందుకు అధికారులు వెనకాడుతున్నారు
official statement	అధికారిక ప్రకటన
by then it was pm	అప్పుడు సమయం రాత్రి  ఈ ఒకటిన్నర గంటలోనే ఎంత స్నేహితులమయ్యామేమో అనిపించింది
theres nothing to be afraid of	ఇందులో భయపడటానికి ఏమీ లేదు
mohammad azharuddins son to marry sania mirzas sister	అజారుద్దీన్ కొడుకుతో సానియా మీర్జా చెల్లి పెళ్లి
not just a poet par excellence he is an excellent singer too	ఒక పాటల రచయితగానే కాకుండా కవిగా కూడా చాలా గొప్ప వ్యక్తి
qualification mbbs msmd diploma	అర్హత సంబంధిత విభాగంలో ఎంఎస్సీ ఎంబీబీఎస్ ఎండీ డీఎన్బీ ఉత్తీర్ణత అనుభవం
general disclosures	జనరల్ ఎక్స్ప్లెటివ్స్
water dripping	కొవ్వు
financially sound	ఆర్థిక పరంగా శుభప్రదంగా ఉంటుంది
take an a size sheet of paper and fold it diagonally to make a square	పరిమాణం యొక్క ఒక సాధారణ షీట్ టేక్ తద్వారా ఒక త్రిభుజం అవుతుంది ఒక మూలలో రెట్లు
i was in a mess	కలుగులో ఎలకనే అయ్యాను
language s	భాష
shetty cant contest elections	ఎన్నికలలో పోటీ చేయడానికి వీల్లేదు
siripuram is a village in guntur district of the indian state of andhra pradesh	సిరిపురం గుంటూరు జిల్లా మేడికొండూరు మండలానికి చెందిన గ్రామం
woke up	ఠక్కున లేచింది
bring it home	స్వదేశానికి తీసుకువెళ్లండి
about lakh people are expected to participate in the event	సుమారు  లక్షల మంది ఆ కార్యక్రమానికి హాజరవుతారని అంచనా
but the government did not accept either of these proposals	కానీ ఈ ప్రతిపాదనలను ప్రభుత్వం పట్టించుకోలేదు
cancer is a terrible disease	క్యాన్సర్ అనేది భయంకరమైనదే
documents to avail loan	రుణం కోసం అవసరమైన పత్రాలు
lakhvi was put under detention after an antiterrorism court granted him bail in the mumbai attacks case on december	ముంబై దాడులకు జకీ ఉర్ రెహ్మాన్ లఖ్వీనే కారణమంటూ నిర్ధారించడానికి సరైన ఆధారాలు లేవంటూ తీవ్ర వాద వ్యతిరేక కోర్టు లఖ్వీకి డిసెంబర్ న బెయిల్ మంజూరు చేసిన విషయం తెలిసిందే
the government is working hard to meet its objective	ప్రభుత్వ కొలువే లక్ష్యంగా శాయశక్తులా యత్నిస్తోంది
is it a risk	ప్రమాదం కదా అంటే చిన్నప్పట్నుంచీ ఎక్కుతూనే ఉన్నాం
in time several other members of the family did the same	చెప్పినట్టుగానే అతను ఇంకెప్పుడూ వెళ్లలేదు
even hindus eat beef	గోమాంసాన్ని హిందువులు కూడా తింటారు
how to plant saplings at home	ఎలా ఇంట్లో ఒక అత్తి చెట్టు పెరగడం
very good	బహు బాగుంది
however the interest paid is not deductible under section c	ఉద్యోగుల భవిష్యనిధిలో జమ అయ్యే మొత్తాలకు సెక్షన్ సీ కింద పన్ను పడదు
follow traffic rules	ట్రాఫిక్ రూల్స్ ఫాలో అవండి
she is mainly worshipped as a south indian mother goddess predominantly in the rural areas of telangana karnataka and maharashtra	ఈ దేవతను తెలంగాణ కర్ణాటక మహారాష్ట్ర రాష్ట్రాలలోని గ్రామీణ ప్రాంతాల్లోని ప్రజలు ఎక్కువగా ఆరాధిస్తారు
labour and licencing authority	లేబర్ అండ్ లైసెన్సింగ్ అథారిటీ
he doesnt recall	అతనికేం గుర్తుండదు
price rs lakh to rs lakh exshowroom delhi	లక్షలు రెండు ధరలు ఎక్స్ షోరూమ్ ఢిల్లీగా ఉన్నాయి
episode the red team weighs in	జనవరి  ఆంధ్ర ప్రదేశ్లో రాష్ట్రపతి పాలన విధించబడింది
jagdalpur is the district headquarters	ఈ జిల్లా కేంద్రము జగదల్పుర్
exercise correctly	సరిగ్గా వ్యాయామం చేయటం
bsnls new rs	బిఎస్ఎన్ఎల్ చెన్నై వెబ్సైట్ ప్రకారం కొత్త రూ
it is his responsibility to safeguard the legitimate constitutional rights	రాజ్యాంగబద్ధ సంస్థల ఔన్యత్యాన్ని కాపాడాల్సిన బాధ్యత తనపై ఉందన్నారు
pm modi inaugurates the dr ambedkar international centre in delhi	న్యూ ఢిల్లీలో ప్రధాని మోదీ డాక్టర్ అంబేద్కర్ ఇంటర్నేషనల్ సెంటర్ ను ఆవిష్కరిస్తున్న దృశ్యం
why do you think	ఎందుకు ఆలోచిస్తారు లెండి కానీ
their marching columns some feet m wide are edged by fleeing spiders scorpions beetles frogs and lizards and are followed by birds which prey on these fugitives but apparently not on the ants	పక్షులు పారిపోతున్న పురుగులనే వేటాడతాయి కానీ చీమలను వేటాడవు
im in heaven	శంఖంలోని నేను
its very beautiful	ఇది చాలా అందంగా ఉంది
we try to work to get the goals	ఇక నిర్ధారించుకున్న లక్ష్యాలను సాధించేందుకు కృషి చేస్తాం
the youths had consumed liquor	యువతీయువకులు మద్యం తాగుతూ హంగామా చేశారు
it was then the incident came to light	దాంతో సంఘటన వెలుగులోకి వచ్చింది
the judges asked	అని న్యాయమూర్తులు ప్రశ్నించారు
no electronic devices are allowed in the exam hall	ఎలాంటి ఎలక్ట్రానిక్ పరికరాలకు పరీక్ష కేంద్రంలోకి అనుమతించరు
you cant take decisions on your own	సొంతంగా నిర్ణయాలు తీసుకోలేడు
suicides by farmers continue	రైతుల ఆత్మహత్యల పరంపర కొనసాగుతోంది
the magnitude of the earthquake was on the richter scale	భూకంప తీవ్రత రిక్టర్ స్కేల్ పై గా నమోదైంది
it doesnt depend on mood	అది తర్కం మీద ఆధారపడి లేదు
the incident occurred on monday	ఈ ఘటన సోమవారం కరూర్లో జరిగింది
grubben gjh denton oa plant resources of tropical africa	వెంకట్రామాపురంలో తీసిన చిత్రము
dabangg starring salman khan and sonakshi sinha is directed by prabhudeva	సల్మాన్ ఖాన్ సోనాక్షి సిన్హా జంటగా ప్రభుదేవా దర్శకత్వంలో తెరక్కుతున్న దబాంగ్ పై భారీ అంచనాలు ఉన్నాయి
the worst incident took place in the guntur district	గుంటూరు జిల్లాలో దారుణ ఘటన
president obama arrives in saudi arabia	అమెరికా అధ్యక్షుడు బరాక్ ఒబామా రాజ్ఘాట్కు చేరుకున్నారు
the removal of difficulties orders	కష్టాల తొలగింపు ఉత్తర్వులు
the people protested in large number	దీన్ని నిరసిస్తూ ప్రజలు భారీ ఎత్తున నిరసన తెలిపారు
the place has nearly specimens of birds animals and reptiles	ఎగువన మరియు మొక్కల  పైగా జాతుల అరుదైన జంతువులు క్షీరదాలు కీటకాలు వివిధ కలిగి ఉన్న ఒక భారీ రిజర్వ్ ఉంది
speaker sumitra mahajan in chair	స్పీకర్ సుమిత్రా మహాజన్ తలపట్టుకుని కూర్చున్నారు
want to increase height	మీరు ఎత్తు పెరగాలనుకుంటున్నారా
trs announces candidates for rajya sabha elections	టీఆర్ఎస్ రాజ్యసభ అభ్యర్థులు ఖరారు
for example a spunky year old woman refused to be bullied	ఉదాహరణకు ధైర్యస్థురాలైన  ఏళ్ళ ఒక స్త్రీ తనను అలా జడిపించడానికి ఒప్పుకోలేదు
crores and rs	కోట్లు అల్లుడు రూ
i cant do	నేను చేయలేను
on the other hand employees continued their strike for consecutive days	ఇక అదే సమయంలో గత  రోజులుగా కార్మికులు సమ్మె చేస్తున్నారు
are you taking steps towards it	మీరూ ఆ దిశగా అడుగులేస్తారా
the network grew	నెట్వర్క్నూ విస్తరిస్తోంది
lenders sold shares in tycoon anil ambani s companies after the value of collateral plummeted	కోలేటరల్ విలువ తగ్గిపోవడంతో అనిల్ అంబానీ కంపెనీల షేర్లను అప్పులిచ్చిన వాళ్లు ఇటీవల మార్కెట్లో అమ్మేశారు
parents of the girl demanded stern action against the accused	బాధితుడిపై కఠిన చర్యలు తీసుకోవాలని బాధితురాలి తల్లిదండ్రులు డిమాండ్ చేస్తున్నారు
similarly rs	అదేవిధంగా నారాయణగూడ క్రాస్రోడ్స్లో రూ
i did watch arjun reddy	అర్జున్ రెడ్డి చూశాను
sincerely s	ఇట్లు ఎస్
the results are scheduled to be announced on monday	సోమవారం ఫలితం తేలనుంది
a bx sucrose solution has grams of sucrose per grams of liquid or to put it another way grams of sucrose sugar and grams of water exist in the grams of solution	ఒక   సుక్రోజ్ ద్రావణంలో ప్రతి  గ్రాముల ద్రవంలో  గ్రాముల సుక్రోజ్ ఉంటుంది లేదా మరోరకంగా చెప్పాలంటే  గ్రాముల ద్రావణంలో  గ్రాముల సుక్రోజ్ మరియు  గ్రాముల నీరు ఉంటుంది
happy to be home he added	సొంత ఇంటికొచ్చినంత ఆనందంగా ఉంది అని చిరునవ్వులు చిందిస్తూ ప్రకటించారు
houses are tidied up	ఇండ్లు మెల్లగనే కడుతున్నం
hence love stories stay evergreen	అందుకే ప్రేమకథలు ఎప్పుడూ పుట్టుకొస్తూనే ఉంటాయి
how did he die	అతడికి ఎలా అంతమొందించాడు
it is a great opportunity for him	ఇది తనకొచ్చిన గొప్ప అవకాశమని పేర్కొన్నారు
rs lakh	లక్షల నగదు తీసుకుని వచ్చాడు
dont go back	తిరిగి వట్టిపోవడమూ కద్దు
tanzania is a rich country	నా దేశం సంపన్న దేశం
we should help them secure these rights	అటువంటి దుర్మార్గులకు సహాయం అందించే వాడేవాడు లేడు
families in darkness	చీకటి కుటుంబాల్లో వెలుగులు
two killed in shootout	ఘటనా స్థలిలోనే ఇద్దరి మృతి
blog manifestoare blogs doing any good for internet	బ్లాగ్ మానిఫెస్టో బ్లాగులు ఇటర్నెట్టుకు మేలు చేస్తున్నాయా
gadkari is pitted against former mp and congress leader nana patole in nagpur	బీజేపీ మాజీ ఎంపీ కాంగ్రెస్ అభ్యర్థి నానా పటోల్ను గడ్కరీ ఢకొీంటున్నారు
home national highstakes for congress in karnataka bypolls	జాతీయం  కర్ణాటకలో ఎన్నిక వాయిదా
do you even need one	ఇది మీకు కూడా అవసరం కదా
pause playback	ప్లేబ్యాక్ నిలిపిఉంచుము
i can make suggestions	సలహాలు ఇవ్వచ్చు
please please come quick	నన్ను త్వరగా అక్కడకు తీసుకువెళ్ళండి  అన్నాడు
englands first innings is over	దీంతో ఇంగ్లండ్ తొలి ఇన్నింగ్స్ ముగిసింది
the movie is directed by rajamouli and produced by danayya under dvv entertainments	రాజమౌళి దర్శకత్వంలో ప్రతిష్టాత్మకంగా రూపొందుతున్న ఈ మూవీని డీవీవీ ఎంటర్టైన్మెంట్స్ బ్యానర్పై దానయ్య నిర్మిస్తున్నారు
food essentials	ఆహార బేసిక్స్
bjp leaders are lying	బిజెపి నాయకులు అనవసర రాద్ధాంతం చేస్తున్నారని అన్నారు
chaotic traffic	దూకుడు ట్రాఫిక్
but i dont worry	కానీ నేను సంకోచించరు
of the rs	వారి వద్ద నుంచి రూ
rather than restrict us he gives us loving direction for our good	మనకేది మంచిదో ఆయనకు బాగా తెలుసు
no shots are fired no bombs are dropped but war strategy is no less intense	తుపాకుల చప్పుళ్లు లేవు బాంబుల వర్షాలు లేవు అంత మాత్రాన యుద్ధవ్యూహం తక్కువైనది కాదు
is congress	కాంగ్రెస్ వైపా
further if you are buying or selling a property worth more than lakh of the value is deducted as tds by the buyer	లక్షలు లేదా అంతకంటే ఎక్కువ ఉన్నప్పుడు కొనుగోలు దారుడు ఆస్తి విలువను చెల్లించేప్పుడు  శాతం టీడీఎస్ను డిడక్ట్ చేయాలి
why cheat	ఎందుకు కల్పితమా
so far rs	ఇప్పటివరకు భారతదేశ చరిత్రలో రూ
budget allocations	బడ్జెట్ కేటాయింపు వివరాలు
robert vadra appears before ed for questioning	ఈడీ ముందు రాబర్ట్ వాద్రా హాజరు
five people died on the spot	దాంతో ఐదుగురు అక్కడికక్కడే మృతి చెందారు మరో
three thieves held	ముగ్గురు దొంగలు
the skin appears fresher and cleaner	చర్మం తాజాగా తేమగా మారుతుంది
how much storage do i need	ఎంత ఐప్యాడ్ నిల్వ అవసరం
god results are graceful	ఫలశృతిలో చెప్పిన విషయాలు విశ్వాసాన్ని పెంచుతున్నాయి
i thought	అనుకుంది మనసులో
shes undergoing treatment at a local hospital	బాధితుడు జిల్లా ప్రభుత్వాసుపత్రిలో చికిత్స పొందుతున్నాడు
no need to be	కలవాల్సిన అవసరం లేదు కూడా
big profits	భారీగా లాభం
top losers in the sensex pack included indusind bank yes bank sbi lt tata steel mm bajaj finance vedanta tata motors and ril	సెన్సెక్స్లో నష్టపోయిన ఇతర షేర్లలో ఇండస్ ఇండ్ బ్యాంక్ యెస్ బ్యాంక్ ఎస్బీఐ ఎల్ అండ్ టీ టాటా స్టీల్ మహీంద్రా బజాజ్ ఫైనాన్స్ వేదాంతా టాటా మోటార్స్ ఆర్ఐఎల్ ఉన్నాయి
some things havent changed	కొన్ని మారలేదు
traders comments	అభిప్రాయాలు దుకాణదారులను
it was not recognized internationally	ఇది అంతర్జాతీయంగా గుర్తించబడలేదు
a team led by dsp samunder singh patrolled the city to avoid any untoward incident	దీంతో ఎలాంటి అవాంఛనీయ ఘటనలు జరగకుండా జిల్లా ఎస్పీ సింధు శర్మ ఆధ్వర్యంలో పోలీసులు బందోబస్తు నిర్వహించారు
body blows	రాలిపోయేది దేహమే
monthly fee	నెలవారీ బిల్లు
jeff bezos amazon ceo and the worlds richest persons smartphone the iphone x was reportedly hacked by saudi arabia prince through a malicious whatsapp message	ప్రపంచంలో నంబర్ వన్ ధనవంతుడైన అమెజాన్ ఓనర్ జెఫ్ బెజోస్ ఐఫోన్నూ వాట్సాప్ ద్వారానే హ్యాక్ చేశారని వార్తలొచ్చాయి
but he wasnt scared	అయినా తాను భయపడబోనని అన్నారు
a mother and child	తల్లితోబాటు పిల్లలు కూడా
he still has a lot to learn	తను నేర్చుకోవాల్సింది ఇంకా చాలా ఉంది అని చెప్పారు
use sesame or coconut oil	గోరువెచ్చని ఆలివ్ లేదా కొబ్బరినూనెను వాడండి
lakh at least	లక్షల వరకు చెల్లించాల్సి ఉంది
must try	పరీక్షించాలి
paint ladders	కనపడని నిచ్చెన
dump the entire uis xml description to the console	మొత్త యొక్క  వివరణను తెర కన్సోల్కు డంపుచేయుము
i get up early and witness to people at bus stops in parking lots on the street in shops or in parks	నేను ఉదయాన్నే లేచి బస్టాపుల్లోను పార్కింగ్ స్థలాల్లోను వీధుల్లోను దుకాణాల్లోను పార్కుల్లోను సాక్ష్యం ఇస్తున్నాను
so say it	కనుక చెప్పి తీరాలి
mind is blown	బుద్ధి వక్రించింది
crores	కోట్లు అందుకున్నాడు
avoid exercising after having meals	ల ఆహారం తీసుకున్న తరువాత వ్యాయామం అన్నది చేయకూడదు
the driver was not injured in the accident	కాగా ఈప్రమాదంలో డ్రైవర్ బాలరాజుకు ఎలాంటి గాయాలు కాలేదు
lakh crores	లక్షలు ఖర్చు చేశారు
it received tremendous response	దానికి అద్భుతమైన స్పందన వచ్చింది
people in the	ప్రజలు బనగానపల్లెలో
yes say researchers	అంటే అవుననే విశ్లేషకులు చెబుతున్నారు
sometimes it can even lead to death	అంతే కాకుండా కొన్ని సందర్భాల్లో అది మరణానికి కూడా దారి తీయవచ్చు
for example some complicate their lives by living beyond their means	నిజమే ఏదైనా ఉద్యోగం సంపాదించుకోవడానికి కొంతస్థాయి వరకు విద్య ప్రయోజనకరమైనదే
moreover its fast as well	అదనంగా ఇది చాలా త్వరగా చేస్తాను
its totally untrue	పూర్తిగా అపనమ్మకంగా వుంది
shops in market complexes except those within the limits of municipal corporations and municipalities would be allowed to open	మునిసిపాలిటీలు మునిసిపల్ కార్పొరేషన్ల పరిధిలోకి వచ్చేవి మినహా అన్ని మార్కెట్ సముదాయాల్లోని దుకాణాలు తెరిచేందుకు అనుమతించవచ్చు
but the situation changed soon	కానీ కొద్ది కాలంలోనే పరిస్థితి నాటకీయంగా మారింది
mortality rates are high	మృతుల రేటు ఇక్కడ ఎక్కువే
your blood	మీ రక్తం
rule of law	చట్టబద్ధమైన పాలన
as a result some converted to islam	కొంతమంది ఇస్లాం మతానికి మారారు
slowly love blossomed between the two	క్రమేణా ఈ పరిచయంతో ఇద్దరి మధ్య ప్రేమ చిగురించింది
the climate has changed drastically	వాతావరణ చాలా గంభీరంగా మారిపోయింది
afterwards he established the school of dramatic arts and became the principal of bombays natya academy	తరువాత స్కూల్ ఆఫ్ డ్రామాటిక్ ఆర్ట్స్ ను స్థాపించాడు బొంబాయి నాట్య అకాడమీకి ప్రిన్సిపాల్ గా నియమించబడ్డాడు
whats the story	ఇంతాకీ ఏమిటా కథ
raisins are rich in iron and vitamin bcomplex	ఎండు ద్రాక్షలో ఐరన్ మరియు విటమిన్ బికాంప్లెక్స్ లు అధికంగా ఉంటాయి
but thats really it	కానీ ఇది నిజమైన విషయం
kl rahul out	ఓపెనర్ కేఎల్ రాహుల్ అవుట్
nobody can stop the people	మనుషులెంతటివారయినా నిరోధింపలేరు
the carnival is expected to be launched at the delhi auto expo	వీటిని అతి త్వరలో జరగబోయే  ఢిల్లీ ఆటో ఎక్స్పోలో ప్రదర్శించనున్నారు
assembly in shivaji park uddhav thackeray sworn in as cm	శివాజీ పార్క్లో ముఖ్యమంత్రిగా ఉద్ధవ్ ఠాక్రే ప్రమాణ స్వీకారం
crore	కోట్లు నష్టపోయారు
on the occasion of ganesh chaturthi andhra pradesh governor sri biswa bhusan harichandan conveyed his warm greetings and good wishes to the people	వినాయక చవితి సందర్భంగా గవర్నర్ బిశ్వ భూషణ్ హరిచందన్ ప్రజలకు శుభాకాంక్షలు తెలిపారు
the causes can be permanent or temporary	అనుమతులు తాత్కాలికంగా లేదా శాశ్వతంగా ఉంటాయి
the state government is no way involved in the incident	దీన్ని కొలిక్కి తెచ్చేందుకు ఇటు రాష్ట్ర ప్రభుత్వ యంత్రాంగం చొరవ చూపటం లేదు
keep it fun	ఆహ్లాదంగా ఉండండి
thereafter shah left for hyderabad	అనంతరం పవన్ హైదరాబాద్ కు బయలుదేరారు
how to do	ఎలా చేయాలి
courtesy the hindu	హిందూ సౌజన్యంతో
no guesses required	ఇందుకు ఎలాంటి జోస్యాలూ అవసరం లేదు
but the decision was taken	అయితే తీర్మానాన్ని ఆమోదించి
apple murabba	ఆపిల్ స్మూతీస్
think about it another way	మరొక రీతిగా ఆలోచించవద్దు
indian skipper virat kohli reclaimed the top spot in batting in the recent icc odi player rankings	దీంతో ఐసీసీ తాజాగా ప్రకటించిన ర్యాంకింగ్స్లో భారత పరుగుల యంత్రం విరాట్ కోహ్లి అరుదైన ఘనతను అందుకున్నాడు
students are advised to work hard to get good results in the studies	విద్యార్థులకు చదువులో ఉత్తమ ఫలితాలు రావడానికి సంకల్పంతో కృషి చేయాలని అన్నారు
praise yahweh jerusalem praise your god zion	యెరూషలేమా యెహోవాను కొనియాడుము సీయోనూ నీ దేవుని కొనియాడుము
ghee teaspoon	మీగడ   చెంచా
it is high in fibre vitamin b potassium and essential amino acids	వీటిలో ప్రొటీన్ పిండిపదార్థాలు విటమిన్బి క్యాల్షియంతోపాటు అధిక పోషకాలు కలిగి ఉంటాయి
rest of the drama is how krishnudu wins the heart of lakshmipati	కృష్ణుడు లక్ష్మీపతి హృదయాన్ని ఎలా గెలుచుకుంటాడనేది మిగిలిన కథ
tthe election commission ec released the schedule on thursday	కేంద్ర ఎన్నికల సంఘం గురువారం ఎన్నికల షెడ్యూల్ విడుదల చేసింది
crore	కోట్లు మూడో రోజు రూ
but the project has not fructified	అయితే ఏళ్లు గడుస్తున్న ఆ ప్రాజెక్ట్ పట్టాలెక్కలేదు
put your mind in devotion to god	మనసును దైవంపైనే నిలపాలు
their number is more than	దాదాపు వీరి సంఖ్య  లక్షల పైన
he entered the house and raped the girl	బాలిక పై ఇంట్లోకి చొరబడి ఆమెను బెదిరించి అత్యాచారానికి పాల్పడ్డాడు
but delhi voters are not impressed at all	అయితే ఢిల్లీ ఓటర్లు ఓటింగ్ వేయడానికి పెద్దగా ఆసక్తి చూపించక పోవడం విశేషంగా చెప్పుకోవచ్చు
no law and order exists in the state	సమాజంలో న్యాయం చట్టం ఏవీ లేవు
it is like a village	పల్లె అమ్మ వంటిది
principal arrested for molesting student	విద్యార్థిని ఫిర్యాదుపై ప్రిన్సిపాల్ అరెస్టు
suicide in adolescents and young adults	పిల్లలు మరియు కౌమారదశలో ఆత్మహత్య
dont compete	పోటీ పడి ఏరుకోం
k chandrasekhara rao	కె రాఘవేంద్రరావు
starring abhishek bachchan taapsee pannu and vicky kaushal in the lead role manmarziyaan is directed by anurag kashyap	తాప్సీ పన్ను విక్కీ కౌశల్ అభిషేక్ బచ్చన్ ప్రధాన పాత్రల్లో నటించిన మన్మర్జియాన్ చిత్రానికి అనురాగ్ కశ్యప్ దర్శకత్వం వహించారు
ranveer singh and deepika padukone are among the most loved celebrity couples in bollywood	ఎట్టకేలకు బాలీవుడ్ స్టార్ కపుల్ దీపికా పదుకొనె రణ్వీర్ సింగ్ తమ ప్రేమకు పుల్స్టాప్ పెట్టబోతున్నారు పెళ్లితో ఒక్కటి కాబోతున్నార
available remote addons	అందుబాటులోని రిమోట్ పొడిగింతలు
inx media case cbi files charge sheet against p chidambaram others	ఐఎన్ఎక్స్ మీడియా కేసులో పీకల్లోతు చిదంబరంపై ఛార్జిషీట్ ఆయన కుమారుడితో సహా  మంది
it is an irrefutable truth	ఇది కాదనలేని సత్యం ఆ ప్రభావం మంచీ కావొచ్చు
crores	కోట్ల సమీకరించనుంది
he denied the reports	ఈ వార్తలను ఖండిస్తున్నానని తెలిపారు
salary rs	వేతనం  మొదటి ఏడాది శిక్షణ సమయంలో నెలకు రూ
arun jaitley arun jaitley death	అరుణ్ జైట్లీ కన్నుమూత ప్రముఖుల సంతాపం
later he addressed a news conference	అనంతరం స్తానిక విలేకరుల సమావేశంలో ఆయన మాట్లాడారు
the right hand	కుడి వైపు
children too	అలాగే సంతానం కూడా
a chargesheet was filed in court	కోర్టులో ఛార్జీషీట్ దాఖలు చేశారు
people c	జనం నీరాజనం
he was relegated to the third place	అవమానకరంగా మూడోస్థానానికి పడిపోయింది
the state of assam has witnessed protests since the introduction of the bill in the lok sabha last month	గతేడాది డిసెంబర్లో పార్లమెంట్ సమావేశాల్లో బిల్లును ప్రవేశపెట్టగానే అసోం రాష్ట్రంలో ఆందోళనలు మిన్నంటాయి
so let us now continue to strengthen our faith and to work whole souled as to jehovah	కాబట్టి మన విశ్వాసాన్ని బలపర్చుకుంటూ ఉందాం యెహోవా సేవ చేసేందుకు చేయగలిగినదంతా చేద్దాం
she suffered per cent burns and died during treatment at a hospital	దాదాపు శాతం కాలిన గాయాలతో ఆసుపత్రిలో చావుబతుకుల మధ్య కొట్టుమిట్టాడుతు మరణించాడు
however players walked off the field just as the rain arrived	అయితే ఒక్క బంతి కూడా పడకముందే వర్షపు జల్లు మొదలవడంతో ఆటగాళ్లంతా మైదానాన్ని వీడారు
theyre growing	వాళ్లు పండించుకుంటారు
the accident caused a major traffic jam on the road	దాంతో రోడ్డుపై వాహనాల రద్దీ లేకపోవడంతో పెద్ద ప్రమాదం తప్పింది
we already made plans	అప్పుడే ప్రణాళికలు సిద్ధం చేసుకున్నాం
sye raa is directed by surender reddy and is based on the life story freedom fighter uyyalawada narasimha reddy	స్వాతంత్ర సమర యోధుడు ఉయ్యాలవాడ సైరా నర్సింహారెడ్డి జీవిత కథ ఆధారంగా సైరా సినిమా తెరకెక్కుతున్న విషయం తెలిసిందే
let us examine it	దాన్ని మనం డిస్కస్ చేసుకుందాం అని చెబుతుంటాను
why did he kill himself	ఎందుకు ఆత్మహత్య చేసుకుంది
but no inquiry was made	కానీ ఎలాంటి పరిశీలన చేయలేదన్నారు
every role has a reversal	ఇందులో ప్రతి ఒక్క రోల్ కు ఒక ఇంపార్టెన్స్ ఉంది
not good for bjps politics	బీజేపీ తీరు ప్రజాస్వామ్యానికి మంచిది కాదు
is it really gods intent	వాస్తవానికి దేవుని ఉద్దేశము కూడా అదే కదా
the cbi has taken over the probe in three cases related to the alleged rape of a yearold girl by bjp mla kuldeep singh sengar	సంచలనం సృష్టిస్తున్న ఉన్నావ్ రేప్ కేసులో బీజేపీ ఎమ్మెల్యే కుల్దీప్సింగ్ సెంగర్ అరెస్ట్ చేసింది సీబీఐ   ఏళ్ల బాలికపై అత్యాచారం కేసులో కుల్దీప్సింగ్ సెంగర్పై ఉత్తర ప్రదేశ్ పోలీసులు ఇప్పటికే కేసులు నమోదు చేశారు
do not neglect anything	ఏమాత్రం నిర్లక్ష్యం చేయకూడదు
another criminal brandished a gun at his head	మరో దుండగుడు క్యాషియర్ తలకు తుపాకి గురి పెట్టాడు
it is lakh hectares more than last years target	గత ఏడాది కంటే దాదాపు  లక్షల ఎకరాలు అదనంగా సాగు కావడం విశేషం
he urged the government to stop harassing the people	ప్రజలకు ఇబ్బంది పెట్టే పనులను ప్రభుత్వం మానుకోవాలని కోరారు
priyankanick mumbai wedding reception see pics	ముంబైలో ప్రియాంక నిక్ నిశ్చితార్థ వేడుక
we can only assist	మేం కేవలం సాయం చేసి ఆగిపోం
the meeting would be attended by senior ministers and bureaucrats	సీఎంలతోపాటు మంత్రులు సీనియర్ అధికారులు ఈ భేటీలో పాల్గొంటారు
it is very exciting and interesting	ఈ చాలా ఆసక్తికరమైన మరియు ఉత్తేజకరమైన ఉంది
however detailed investigation was still going on	కానీ మరింత వివరంగా అధ్యయనం ఇప్పటికీ కొనసాగుతోంది
none of english	ఇంగ్లిషు వద్దనడం లేదు
ips officials transferred in ap	ఏపీలో భారీగా ఐఏఎస్ అధికారుల బదిలీలు
in the past rs	గతంలో ఇల్లు కొనగోలు కోసం ప్రమిల బాలాజీకు రూ
crore	కోట్లు తోటపల్లి ప్రాజెక్టుకు రూ
something was afoot	ఏదో అంటి ముట్టనట్టు ఉండేవారు
the bjp people are spreading hatred in the name of religion caste and region	పౌరసత్వానికి మతం కులం ప్రాంతం పేరిట బీజేపీ చిచ్చులు పెట్టడం దారుణమన్నారు
the death toll is likely to increase	మృతుల సంఖ్య పెరిగే అవకాశమున్నట్లు తెలిపా రు
his family members immediately shifted him to osmania hospital	ఇది గమనించిన కుటుంబ సభ్యులు వెంటనే మిద్దెపైకి వచ్చి అతడిని ఉస్మానియా హాస్పిటల్లో చేర్పించారు
thousand	వేల రాయితీనిచ్చాయి
black and gold saree	బ్లాక్ అండ్ గోల్డ్ శారీ
came along	తో వచ్చింది
lets look at some of these	అటువంటి కొన్ని రాగాలను చూద్దాం
bjp in wait and watch mode	వేచిచూసే ధోరణిలో బీజేపీ
happy republic day to everyone	అందరికీ గణతంత్ర దినోత్సవ శుభాకాంక్షలు
the turmeric and honey face mask helps to lighten dark spots and acne scars	శెనగపిండి బాదం మిశ్రమం ముఖంలో మచ్చలను మొటిమలను తగ్గించి ముఖానికి కాంతిని అందిస్తుంది
issuing notices to	దఫదఫాలుగా నోటీసులు
alternative shelter	ప్రత్యామ్నాయ వసతి
therefore people must uplift their morale by looking forward to celebrating these festivals albeit in a different way	అందువల్ల ప్రజలు ఈ ఉత్సవాలను వేరే విధంగా జరుపుకునేందుకు ఎదురుచూడటం ద్వారా వారి ధైర్యాన్ని పెంపొందించుకోవాలి
according to the results updated on the election commission website late tuesday night jdus krishnamurari sharan alias prem mukhiya has polled votes while the rjds atri muni alias shakti singh yadav has got votes	జేడీయూ నుంచి పోటీ చేసిన కృష్ణమురారి శరణ్ అలియాస్ ప్రేమ్ ముఖియాకు   ఓట్లు ఆర్ జేడీ పార్టీ నుంచి పోటీ చేసిన అత్రి ముని అలియాస్ శక్తిసింగ్ కు   ఓట్లు వచ్చాయని ఎన్నికల అధికారులు తెలిపారు
the bjp	బీజేపీ టీడీపీ
the child died the next day	మరుసటి రోజున బిడ్డ మృతి చెందింది
mix the dry ingredients	పొడి మిశ్రమం కలపాలి
the materials include	దీని పదార్ధాలు
one such video	ఇలాంటి వీడియోనే ఒకటి
it is ridiculous for bjp to include such a party and individual	అలాంటి పార్టీని వ్యక్తిని బీజేపీ కలుపుకోవడంవిడ్డూరం
go back to sleep	ఇటు తిరిగి పడుకో
ingredients for preparing sabudana wadas	సాబుదానా వడ తయారుచేయడానికి కావాల్సిన పదార్థాలు
the megapixel camera can take quick shots	మెగా ఫిక్షల్ కెమెరాతో అదిరిపోయే విధంగా ఫోటోలు తీయవచ్చు
she posted the video on social media	ఈ తతంగాన్ని వీడియో తీసి సోషల్ మీడియాలో పడేశాడు
one of them is paddy	వాటిలో కల్పవృక్షం ఒకటి
but modi failed to do so	కానీ అలా చేయకుండా మోడీ మోసం చేశారని
another blow for tdp	ఏపీలో టీడీపీకి మరో షాక్ తగిలింది
please select an option	ఒక ఎంపికను ఎంచుకోండి
regimen are as follows	రెసిపీ ఈ క్రింది విధంగా ఉంటుంది
how did you get into the movies	సినిమాల్లో పాడే అవకాశం ఎలా వచ్చింది
but it isnt just the centre alone	అయితే కేంద్రం ఒక్కటే చొరవ చూపించడం కాదు
to which he responded on twitter	అంటూ ట్విట్టర్ లో స్పందించారు
two arrested for looting stealing atms	ఏటీఎంలో చోరీకి విఫలయత్నం ఇద్దరు నిందితుల అరెస్ట్
however he falls for her and decides to couple up	అయితే అతను ఆమెను ప్రేమించి పెళ్ళికి సిద్ధపడతాడు
crores	కోట్లకు అమ్ముడైంది
vijay sethupathi is a really good actor	విజయ్ సేతుపతి ఒక నటుడు
at the canada open super tournament parupalli kashyap and sourabh verma progressed to the prequarterfinals	కెనడాలోని క్లాగరీ వేదికగా జరుగుతున్న కెనడా ఓపెన్ సూపర్  బ్యాడ్మింటన్ టోర్నీలో కామన్వెల్త్ గేమ్ ఛాంపియన్ పారుపల్లి కశ్యప్ సౌరభ్ వర్మలు ప్రీక్వార్టర్ ఫైనల్లోకి ప్రవేశించారు
soon after	మరికొద్ది సేపట్లో
it employs about cybersecurity professionals and has over customers globally	ఔజాస్ కంపెనీకి ప్రపంచ వ్యాప్తంగా  కస్టమర్లు ఉండగా  మంది ఉద్యోగులు పని చేస్తున్నారు
a bjp mla in up raped a woman	ఉత్తరప్రదేశ్లో ఒక బీజేపీ ఎమ్మెల్యే ఒక బాలికపై అత్యాచారానికి పాల్పడ్డారన్నారు
condolences to families of the victims who lost their lives	ప్రమాదంలో మృతిచెందినవారి కుటుంబాలకు ప్రగాఢ సంతాపం తెలియ జేశారు
moto g plus specifications features	మోటో జీ ప్లస్ ఫీచర్లు
her father is a property dealer and a farmer	ఆమె తండ్రి ఒక ఐరిష్ రైతు మరియు స్టాక్ డీలర్
it is a sheer delight	అదొక పైశాచిక ఆనందం
the marriage	పెళ్లికి వచ్చే
earthquake hits southern california second in two days	కాలిఫోర్నియాలో భారీ భూకంపం రెండు దశాబ్ధాల తర్వాత తీవ్రస్థాయిలో ప్రకంపనాలు
a number of mps and mlas participated in the meeting	ఈ కార్యక్రమంలో పలువురు ఎమ్మెల్యేలు శాసన సభ సిబ్బంది పాల్గొన్నారు
his death has left the family shattered	ఈ మృతి తమ కుటుంబాన్ని తీవ్ర విషాదంలోకి నెట్టిందన్నారు
it has built the worlds highest bridge at metres over chenab river	ఈ వంతెన చెనాబ్ నది మట్టానికి  మీటర్ల ఎత్తులో ఉంటుంది
several members spoke on it	ఈ సందర్భంగా పలువురు ఎంపీలు మాట్లాడారు
onions chopped	కొత్తిమీర  సన్నగా తరిగి పెట్టుకోవాలి
course fee rs	కోర్సు రుసుము రూ
i remember	నాకింకా గుర్తుంది
no reasons given	ఎలాంటి కారణాలు చెప్పలేదు
rs crore	కోట్ల ఆదాయాన్ని పొందుతోంది
she was bleeding profusely when she was rushed to a nearby hospital	తీవ్ర రక్తస్రావంతో కావడంతో తర్వాత అతణ్ని దగ్గర్లోని ఆస్పత్రిలో చేర్పించింది
the augmented satellite launch vehicle aslv	ఆగ్మెంటెడ్ శాటిలైట్ లాంచింగ్ వెహికిల్ ఏఎస్ఎల్వీ
impart values start teaching your child at an early age about honesty integrity and respect	మీ విలువల గురించి స్పష్టంగా ఖచ్చితంగా చెప్పండి
malaria is transmitted by infected mosquitoes	దోమ కాటు ద్వారా మలేరియా వ్యాపిస్తుంది
their objective is different	వీరి ప్రవృత్తి మాత్రం దానికి భిన్నమైంది
women whisper	మహిళలు సాగదీయడం
so it is very disappointing	కాబట్టి ఇది విశేష దుఃఖాన్ని కలిగిస్తున్నది
by the fourth century bce artisans began cutting pebbles into smaller pieces permitting greater precision	టెస్సేరలు వివిధ రంగులు లభ్యమయ్యేలా చేయడమే గాక కావలసిన నమూనాకు తగ్గట్టు సులభంగా అమర్చగల సౌలభ్యాన్ని కలిగించాయి
music is delivered by devi sri prasad	దేవీశ్రీప్రసాద్ మ్యూజిక్ ఇస్తున్నాడు
however her presence isnt finalised yet	అయితే ఈయన అభ్యర్థిత్వం ఇంకా ఖరారు కాలేదు
choose start menu folder	స్టార్ట్ మెనూ సంచయాన్ని ఎంచుకోండి
the first prize of rs	అందులోంచి ప్రథమ బహుమతిగా రూ
the number of stray dogs had increased in rural as well as urban areas	ఇక కుక్కల సంఖ్య రానురాను పెరగడంతో అవి పల్లె పట్టణాల్లో ఎక్కువైపోతున్నాయి
join the debate	చర్చలో పాల్గొనాలి
we are at the cusp of the fourth industrial revolution	నాలుగో పారిశ్రామిక విప్లవంలో మాత్రం చురుగ్గా పాల్గొంటాం
by the sea	సముద్రం ద్వారా
the complete picture	ది కంప్లీట్ పిక్చర్
has three daughters and a son	తంగరాజ్కి ఒక కూతురు కొడుకు
thus began a new chapter in his life	అందువలన అతను తన జీవితచరిత్రలో ఒక కొత్త పేజీ తెరిచారు
the indian team won the toss and elected to field	టాస్ గెలిచిన భారత్ జట్టు ఫీల్డింగ్ను ఎంచుకుంది
it shot up by percent	రెట్లు పెరిగాయి
position midfielder	పొజిషన్ మిడ్ఫీల్డర్
the village story	పల్లెటూరి కథ
crore	కోట్ల ఆదాయం వచ్చింది
love signs	ప్రేమకు సంకేతం
everybody knows	అందరికీ విమలక్క సుపరిచితమే
well was it in the interest of the nation or your clients	నిజానికి ఇది దేశప్రయోజనాల కోసమా లేక మీ క్లయింట్ ప్రయోజనాల కోసమా మొత్తం మీద ఆరోజులలో మీరు రాత్రిళ్లు నిద్రలేకుండా కష్టపడవలసివచ్చింది
is being sold at rs	కు అమ్మేది
the organisation includes more than scientists and about other scientific technical and supporting personnel	మొత్తం డీ ఆర్ డీ ఓ సంస్థలో  పైగా సైంటిస్టులు షుమారు  మంది సహాయక సిబ్బంది ఉన్నారు
crores	కోట్లు వెచ్చించింది
he is a medical doctor	ఆమె డాక్టర్
vijayashanti prakash raj sangeetha rajendra prasad rao ramesh are seen in key roles	ప్రకాశ్రాజ్ సంపత్రాజ్ పోసాని రావు రమేశ్ కీలక పాత్రలు పోషిస్తున్నారు
no increase in bus fares	రైల్వే ఛార్జీలు పెంచడం లేదు
want to get into politics	రాజకీయాల్లోకి రావాలనుకుంటున్నారా
the situation is almost same in other parts of the city	దేశంలోని ఇతర నగరాల్లోను దాదాపు ఇదే పరిస్థితి
then we do it	ఆ తర్వాత మేమే
the four youths took the girl to a secluded area and raped her	బాలికను అపహరించిన ఐదుగురు దుండుగులు ఆమెను నిర్మానుష్య ప్రాంతానికి తీసుకెళ్లి సామూహిక అత్యాాచారానికి పాల్పడ్డారు
many of the things we worry about never happen anyway	ఆయన ఇచ్చిన సలహా ఎంతో ఆచరణాత్మకమైనది
the other technical aspects are okayish	ఇతర టెక్నికల్ విభాగాల పనితీరు ఫర్వాలేదనే విధంగా ఉంది
pnb loses in two days	కుంభకోణం నేపథ్యంలో పంజాబ్ నేషనల్ బ్యాంక్ షేర్ విలువ రెండు రోజుల్లోదాదాపు  శాతం పతనమైది
the number of recovered cases among covid patients has risen to as of today	దేశంలో కోవిడ్ నుంచి ఇప్పటిదాకా కోలుకున్నవారి సంఖ్య కు పెరిగింది
or isnt he the real one	లేక అసలు వ్యూహమే లేదా
key benefits include	వినియోగ యొక్క ప్రధాన ప్రయోజనాలు ఉన్నాయి
youre a boy	నువ్వా అబ్బాయ్
but he did not agree to it	కానీ ఆ విషయాన్ని ఆయన ఒప్పుకోవడంలేదు
lakh exshowroom delhi	లక్షలు ఎక్స్షోరూమ్ఢిల్లీ గా ఉండవచ్చు
why is the lockdown necessary	ఎందుకు బ్లాక్లిస్టు అవసరం
england won the cricket world cup	స్వదేశంలో జరిగిన ప్రపంచ కప్  ద్వారా ఇంగ్లాండ్ విశ్వవిజేతగా నిలిచింది
in incheon indian athletes won medals comprising golds	ఆసియా గేమ్స్లో భారత్ మొత్తం  పతకాలు గెలవగా అందులో  బంగారు పతకాలు ఉన్నాయి
it is one among constituencies in the anantapur district	రాప్తాడు శాసనసభ నియోజకవర్గం అనంతపురం జిల్లాలోని  శాసనసభా నియోజకవర్గాలలో ఒకటి
the sons of gershon libni and shimei according to their families	గెర్షోను కుమారులు వారి వారి వంశావళుల చొప్పున లిబ్నీ షిమీ
the government has earmarked rs	గ్రామాల అభివృద్ధికి ఏడాది కాలంగా ప్రభుత్వం రూ
freight corridor gathers speed	వేగం పుంజుకున్న సరకు రవాణా కారిడార్
crore	కోట్లు అందుకుంటున్నాడు
maharashtra assembly to convene next week new mlas to be sworn in	ఇక బుధవారం మహారాష్ట్ర ఎమ్మెల్యేలు ప్రమాణస్వీకారం చేస్తారు
i dont know about the rest	మిగిలిన వూళ్ళ సంగతి నాకు తెలియదు
most of them are selected for the iasips and ifs	దీనిలో ఉత్తీర్ణులైన వారిని ఐఏఎస్ ఐఎఫ్ఎస్ ఐపీఎస్లకు ఎంపిక చేస్తారు
holy picture	పవిత్ర చిత్రం
and are working effectively	మరియు వారు గుణాత్మకంగా పని చేస్తుంది
pakistan is imploding	ాకిస్థాన్పై నిప్పులు చెరుగుతున్నారు
crore and above	కోట్లను అధిగమించినట్లు వెల్లడించింది
but he is a man in a hurry	కానీ బొత్తిగా రెటమతం మనిషి
and his ilk	రి తన లవర
not the both	అంతే కాదు ఇద్దరికీ కూడా
while the topspec lx series costs between rs lakh and rs lakh	లక్షల మధ్య రిటైల్ అవుతుండగా టాప్స్పెక్ ఎల్ఎక్స్ సిరీస్ ధర రూ
he is very good	ఆయన చాలా మంచినాడు పరోపకారి ఊరిలో ఎవరికి కష్టం వచ్చినా ఆదుకొంటాడు
white bread	తెల్ల రొట్టె
three passengers suffered minor injuries in the incident	ఈ ఘటనలో ముగ్గురు ప్రయాణికులకు స్వల్పగాయాలయ్యాయి
telangana protest continues on day two	రెండో రోజూ కొనసాగుతున్న తెలంగాణ బంద్
listen to music	మంద్రస్థాయిలో సంగీతం వినండి
for example the semra copperplate inscription vaguely eulogizes him as someonoe who surpassed makaradhvaja the god of love in handsomeness the ocean in depth the lord of heaven in majesty brihaspati in wisdom and yudhishthira in truthfulness	ఉదాసమేరా రాగిఫలక శాసనం అందంలో ఆయన మకరధ్వజుడినిమన్మధుడు అణిచివేసిన రాజు అని సముద్రంవటి లోతైన వ్యక్తి అని గొప్పతనంలో స్వర్గాధిపతి ఇంద్రుడితో సమానుడని విశ్వసించతగిన వ్యక్తులలో ఆయన యుధిష్టరుడికి సమానుడని శాసనాలు ఆయనను స్తుతించాయి
however the cause of the incident is not known	అయితే ఈ ప్రమాదం జరుగటానికి గల కారణాలు తెలియరాలేదు
i dont know where yet	ఇప్పుడెక్కడున్నదీ తెలియడం లేదు
praise yah blessed is the man who fears yahweh who delights greatly in his commandments	యెహోవాను స్తుతించుడి యెహోవాయందు భయభక్తులుగలవాడు ఆయన ఆజ్ఞలనుబట్టి అధికముగా ఆనందించువాడు ధన్యుడు
it is not intended for only manufacturing for the domestic market or import substitution	దేశీయ మార్కెట్ కు అవసరం అయిన ఉత్పత్తులు తయారుచేయడమే కాదుదిగుమతి ప్రత్యామ్నాయంగా కూడా దీన్ని ఉపయోగించాలన్నది మా ధ్యేయం
i pledge to resolutely keep secret whatever may happen to me	ప్రమాదవశాత్తు ఏదన్నా ప్రమాదం జరిగితే వీరి గురించి పట్టించుకునే వారు కరువయ్యారు
he talked to non jewish women he taught women	ఆయన యూదులుకాని స్త్రీలతో మాట్లాడాడు
we too should change	మనమే ఇంకా మారాల్సి వుంది
youtube go	యూట్యూబ్ గో
looks scary	భయంకరంగా కనిపిస్తోంది
take backup	బ్యాక్ అప్ పొందండి
is the ice melting	మంచు ఖండం వేడెక్కుతోందా
lakh crore	లక్షల కోట్లు
the team comprised professor sc sharma dr sanjeev kumar mr jaideep sareen mr jagvinder singh mann mr jaipal sharma	ఈ బృందంలో ప్రొఫెసర్ విజయేందర్ కుమార్ ప్రొఫెసర్ కె జయప్రసాద్ ప్రొఫెసర్ ఎ వి సింగ్ మదనావత్ ప్రొఫెసర్ హెచ్ రాజశేఖర్ ప్రొఫెసర్ డి ఆర్ భాస్కర్ ప్రొఫెసర్ కనిక శర్మ ప్రొఫెసర్ శైలేంద్ర షరాఫ్ ఉన్నారు
expected an integer but found s	ఊహించినది ఇంటీజర్ను అయితే  కనుగొనబడింది
first ball	ొదటి వికెట్
pawan kalyan file photo	పవన్ కళ్యాణ్ ఫైల్ ఫొటో
change your email preferences	మీ ఈమెయిలు అభిరుచులను మార్చుకోండి
kerala reopens bars	కేరళలో బడులు తెరుచుకున్నయ్
loans amounting to rs	ఇచ్చిన రుణాలు రూ
per bottle	ప్రతి పొక్కు లో  మాత్రలు
polycystic ovarian syndrome pcos is a hormonal disorder in reproductive women	చూసుకున్నాడు వైద్యుడు పాలిసిస్టిక్ ఓవరీ సిండ్రోమ్  ఇందువలన  ఒక స్త్రీ జననేంద్రియ అంతస్స్రావ అని
the new ducati panigale v is powered by a euro compliant cc superquaddro ltwin engine	కొత్త డుకాటీ పానిగలే వి  యూరో  కంప్లైంట్  సిసి సూపర్ క్వాడ్రో ఎల్ట్విన్ ఇంజిన్ని కలిగి ఉంటుంది
money is spent	డబ్బు వృథా అవుతుంది
the duo grabbed two wickets each	ఇన్నింగ్స్కో వికెట్ చొప్పున రెండు వికెట్లు తీశారు
their names	వారి పేరు
crore more	కోట్ల కంటే ఎక్కువ లేదు
residential areas	నివాస ప్రాంతాల ప్రాంతం
exemption notice	విమోచన గమనిక
chancellor angela merkel as the guest to the g conference held in holegenedem	హీలిజేన్డెంలో జరిగిన  సదస్సుకు అతిధేయిగా ఉన్న ఛాన్సలర్ ఏంజెలా మెర్కెల్
restoration of statehood	రెసిడెన్సీ హోదా పునరుద్ధరణ
pipped again	మళ్లీ పెట్రో మోత
i really enjoyed batting at number three in sri lanka	శ్రీలంకలో మూడోస్థానంలో బ్యాటింగ్ చేయ డం బాగా ఆశ్వాదించాను
in the ancient games champions enjoyed widespread admiration	బహుమానమును పొందవలెనని గురి యొద్దకే పరుగెత్తుచున్నాను
bjp suffers humiliating defeat in karnataka polls	కర్ణాటకలో బీజేపీకి ఓటమి భయం
tdp mp cm ramesh is on a hunger strike for kadapa steel factory	కడప ఉక్కు కర్మాగారం సాధించుకునే వరకూ పోరాటం చేస్తామంటూ తాజాగా టీడీపీ ఎంపీ సీఎం రమేష్ దీక్ష చేశారు
keeps cancer away	క్యాన్సర్ రాకుండా నివారిస్తాయి
am i not a lawyer	నేను శాసనసభ్యుడిని కాదా
these laws include commands not to lie not to steal not to murder and not to commit adultery	పిల్లలు ఒక స్వాస్థ్యం అనడానికి కారణం ఏమిటి
seeing them the accused fled	ఆమెను చూసిన నిందితులు పారిపోయారు
rs then	అప్పుడు  ఏళ్లకు నెలకు రూ
whats a president to do	మరి రాష్ట్రపతి ఏంచేయబోతున్నారు
he was taking aim at the bjp	ఆయనను బీజేపీ టార్గెట్ చేసింది
diesel prices are at rs	డీజిల్ రేటు లీటరుకు రూ
selling pressure was observed in all stocks	అన్ని సెక్టార్ల షేర్లలోనూ అమ్మకాల ఒత్తిడి కనిపించింది
the entire incident was recorded in cctv	ఈ సంఘటన మొత్తం లో రికార్ఢు అయ్యింది
crore	కోట్లుగా నమోదు చేసింది
time and suitability	సమయం మరియు సాపేక్షత
to the point of open hostilities	ఇది ముపటి అధ్యయనాలకంటే అధికం
you are alone	నువ్వే మరి
only some came back	కొందరు మాత్రమే ముందుకు వచ్చారు
cost price on request	బేస్ ధర అభ్యర్థనపై
nothing wrong	ఏం బాగోలేదు
several others are doing the same	మరికొంత మంది కూడా అదే దారిలో వున్నారు
colours and patterns	ఆకారాలు మరియు రంగుల వెరైటీ
other medical conditions	ఇతర ఆరోగ్య పరిస్థితులు
credit for gst rate cuts goes to rahul gandhi says congress	జీఎస్టీ తగ్గింపు క్రెడిట్ కాంగ్రెస్ పార్టీదే రాహుల్ గాంధీ
after making a weak opening shares of the company plunged per cent to rs on bse	ప్రారంభంలోనే నీరసంగా ప్రారం భం అయిన షేర్లు శాతం క్షీణించి  రూపాయలకు చేరాయి
the car door opened	అంటూ కారు డోరు తెరిచాడు
the mirzapur block education officer filed a complaint against pawan jaiswal a journalist and a representative of the village head rajkumar pal	జనసందేశ్ టైమ్స్ స్థానిక రిపోర్టర్ పవన్ జైశ్వాల్తో పాటు మీర్జాపూర్ ప్రధాన్ ప్రతినిధి రాజ్కుమార్ పాల్పై కేసు నమోదు చేశారు
its not horrible	అది భయం కాదు
the students parents blamed the school staff for negligence	పాఠశాల సిబ్బంది నిర్లక్ష్య వైఖరి వల్లే తమ పిల్లలకు ఈ పరిస్థితి వచ్చిందని తల్లిదండ్రులు ఆరోపించారు
going into the details	వివరాల్లోకెళితే
the incident took place in uttar pradesh	ఉత్తరప్రదేశ్ రాష్ట్రంలో వెలుగుచూసిందీ ఘటన
mumbai indian captain virat kohli is breaking sachin tendulkars every record	హైదరాబాద్ క్రికెట్లో ఉన్న అన్ని రికార్డులను విరాట్ కోహ్లీ బద్దులు కొడుతూ పోతున్నాడు
their father works as a labourer and mother is a housewife	తండ్రి కూలీగా తల్లి టైలర్ గా పనిచేస్తున్నారు
director srinivas raju	దర్శకుడు శ్రీనివాస్ రావు
yes sir	సార్ సార్
then why has food inflation surged	ఆహార ద్రవ్యోల్బణం మాత్రం ఎదగకుండా ఎందుకు ఊరుకుంటుంది
her negative role in aayirathil oruvan and vallavan was highly praised by viewers and critics	ఆయిరథిల్ ఒరువన్లో ఆమె పాత్రను ప్రేక్షకులు విమర్శకులు ప్రశంసించారు
but the love died soon	కానీ ఆ తర్వాతే ప్రేమ అడ్డదారి తొక్కింది
the defence needs of the country the needs and interests of those who protect the country is one of the highest priorities of our government	మిత్రులారా దేశ రక్షణ అవసరాలను జాగ్రత్తగా చూసుకోవటం దేశాన్ని రక్షించే వారి అవసరాలను వారి ప్రయోజనాలను జాగ్రత్తగా చూసుకోవటం అనేది మన ప్రభుత్వానికి అత్యధిక ప్రాధాన్యతా అంశం
how much do you earn	ఎంత దిగుబడి చేసుకుంటున్నారు
the two fall in love	ఇద్దరు ప్రేమలో పీకల్లోతు మునిగి ఉన్నారు
new delhi the andhra pradesh government is planning to launch an airline named after amaravathi once the state capital is developed	అమరావతి అమరావతి నగర శంకుస్థాపన కార్యక్రమాన్ని నభూతో నభవిష్యతి అన్న విధంగా జరపాలని ఆంధ్రప్రదేశ్ ప్రభుత్వం భావిస్తోంది
power supply in several areas was disrupted owing to the rains	విద్యుత్ సరఫరా నిలిచిపోవడంతో పలు ప్రాంతాలు అంధకారమయ్యాయి
our economic condition has improved a lot	మన ఆర్థిక స్థితి పురోగమిస్తుంది అని వ్యాఖ్యానించారు
however the government has typically maintained an aggressive approach	అయినా ప్రభుత్వం మొండి వైఖరితో నిరంకుశంగా వ్యవహరిస్తోందన్నారు
his disciples found great refreshment serving under jesus authority	యేసు అధికారం క్రింద సేవ చేయడంలో ఆయన శిష్యులు గొప్ప విశ్రాంతిని పొందారు
he reportedly went to office on monday and did not return	ఆదివారమే కార్యాలయానికి వెళ్లి బాధ్యతలు స్వీకరిస్తానని ప్రకటించారు
the future of my government is not in the hands of the opposition	నా ప్రభుత్వం యొక్క భవిష్యత్తు ప్రతిపక్షాల చేతిలో లేదు
basic recommended	ప్రాథమిక సిఫార్సు చేయబడింది
mg zs electric suv deliveries begin first vehicle delivered to eesl	అందులో భాగంగానే తొలి ఎలక్ట్రిక్ ఎంజీ జడ్ఎస్ ఎలక్ట్రిక్ కారును పూర్తి స్థాయిలో మార్కెట్లోకి తీసుకొచ్చారు
aamir khan brother	కరణ్ జోహర్పై విరుచుకుపడిన ఆమిర్ ఖాన్ సోదరుడు
maruti suzuki discounts indias largest car manufacturer offers major discounts	మారుతి సుజుకి బంపర్ ఆఫర్ కార్లపై అదిరిపోయే డిస్కౌంట్
we must ask then is the bible just another religious book	అలాగైతే మనమిలా ప్రశ్నించుకోవాలి బైబిలు కేవలం మతసంబంధమైన పుస్తకం మాత్రమేనా
the examination committee	పరీక్షా కమిటీ
crores	కోట్లను స్వాధీనం చేసుకున్నారు
he was awarded indias highest civilian award the bharat ratna in march	లో భారత ప్రభుత్వం వాజ్పేయికి అత్యంత ప్రతిష్టాత్మకమైన భారత రత్న పురస్కారం అందించింది
congress president sonia gandhi has called upon the leaders of party leaders to join the meeting	సోనియా గాంధీ నిర్వ హించిన సమావేశానికి  పార్టీలకు చెందిన నేతలు హాజరయ్యారు
hundred per cent	ెరో వందకోట్లు
types of loans	తనఖాల రకాల
thousand	వేలు నమ్మలేరు కదూ
producers sahu garapati harish peddi	నిర్మాతలు హరీష్ పెద్ది సాహు గారపాటి
how to choose the right one	ఎలా కుడి పండు ఎంచుకోవడానికి
the incident happened in krishna district in andhra pradesh	తాజాగా ఆంధ్రప్రదేశ్ రాష్ట్రంలోని కృష్ణా జిల్లాలో జరిగిన ఓ సంఘటన కూడా ఇలాంటి కోవకే చెందుతుంది
it tweeted	అంటూ వెటకరంగా ట్వీట్ చేశారు
however upper caste candidates are overrepresented in the lists of the trs the congress and the bjp	అయితే టీఆర్ఎస్ కాంగ్రెస్ బీజేపీ అభ్యర్థులు ఓటర్లకు భారీగా పోటీపడి తాయిలాలు చేరవేశారు
these include both doctors nurses and other health care staff	వీరిలో వైద్య రంగానికి చెందిన డాక్టర్లు నర్సులు కాంపౌండర్లు తదితర సిబ్బంది కూడా ఉన్నారు
umesh yadav took two wickets	ఉమేష్ యాదవ్కు రెండు వికెట్లు లభించాయి
i am safe	నాకు భద్రత
global tenders upto rs crores to be disallowed	కోట్లలోపు కొనుగోళ్లకు గ్లోబల్ టెండర్లకు అవకాశం లేదు
why merger	ందుకు కలిసిపోయాయి
the same was done	దే చేసింది
a new museum	ఓ కొత్త మ్యూజియం
today both matthews and lukes genealogical records remain a part of the foundation of our faith and a testimony to the sureness of the promises of god	యేసు వంశావళి గురించి మత్తయి లూకా సువార్తల్లో ఉన్న వివరాలు ప్రాముఖ్యమైనవి
but she denies it	కానీ ఆమె ఓ షరత్తు పెడుతుంది
photo credit tr	ఫోటో క్రెడిట్
the two coexist	వీరిద్దరు సహజీవనం సాగిస్తున్నారు
implementation is key	అమలు కీలకం
the quake measured magnitudes on the richter scale	రిక్టర్ స్కేల్పై భూకంప తీవ్రత  మాగ్నిట్యూడ్స్ గా నమోదయింది
if you created or downloaded a file but now you cant find it follow these tips	మీరు ఒకఫైలు సృష్టించి లేదా దిగుమతి చేసివుండి దానిని ఇప్పుడు కనుగొనలేక పోతే ఈ కింది చిట్కాలను అనుసరించుము
icici bank launches contactless credit and debit cards	ఐసీఐసీఐ మరో వినూత్న ప్రయోగం కాంటాక్ట్ లెస్ క్రెడిట్ డెబిట్ కార్డులు
should you leave it	ఇట్లా వదిలేయాల్సిందేనా
symptoms and treatments of breast cancer	రొమ్ము క్యాన్సర్ దాని లక్షణాలు మరియు చికిత్సలు
the union leaders venkatrami reddy chandrasekhar reddy bopparaju venkateshwarlu kr suryanarayana and others attended the meeting	ఈ కార్యక్రమంలో బిసి నాయకులు దేవపూజ ధనుంజయచారి కోనేటి వెంకటేశ్వర్లు కోట్ల శ్రీనివాస్ సి రాజేందర్ముదిరాజ్ తదితరులు పాల్గొన్నారు
why removed	ఎందుకు బహిష్కరించాలి
the man faints	మగపిల్లాడు పుడతాడు
and teachers are not the problem	శ సమస్యలు ఉపాధ్యాయులు అవి అడ్డంకులు కావు
he died on route to the hospital	ఆసుపత్రికి తరలిస్తుండగా మార్గమధ్యంలో మృతి చెందాడు
thats a very sad situation	అది చాలా ఇబ్బందికరమైన పరిస్థితి
srikanth addala is the director	ఈ చిత్రానికి శ్రీకాంత్ అడ్డాల దర్శకత్వం వహించనున్నాడు
picture on page	వ పేజీలోని చిత్రం
it can be anyone	అది ఎవరికైనా రావొచ్చు
it is however his personal opinion	అయితే ఇది తన వ్యక్తిగత అభిప్రాయం మాత్రమేనని ఆయన చెప్పడం విశేషం
republic day celebrations pass off peacefully in kashmir	కాశ్మీర్ లో ప్రశాంతంగా ఈద్ వేడుకలు
why is it so hot	ఇది ఎందుకసలు వేడిగా ఉంటుంది
another record in history of medicine	వైద్యచరిత్రలో మరో రికార్డు స్పృష్టించారు
bjp is a part of us	మేమూ ఉన్నామంటున్న బీజేపీ
a month later i started to serve as a traveling overseer	ఒక నెల తర్వాత నేను ప్రయాణ పైవిచారణకర్తగా సేవ చేయడం ప్రారంభించాను
chemical sciences	కెమికల్ సైన్సెస్
the state government gave rs	రాష్ట్ర ప్రభుత్వం మొక్కజొన్న కు రూ
aitraaz received several accolades particularly for chopra	ఐట్రాజ్ అనేక చోట్ల ప్రశంసలు అందుకున్నారు ముఖ్యంగా చోప్రాకు
the temple is included among the divya desams the temples of vishnu celebrated by the alwars poet saints	ఈ ఆలయాన్ని  మంది ఆళ్వారులు కవి సాధువులు నిర్వహించే దివ్య దేశం విష్ణు ఆలయాలలో కలిపారు
europe and asia	నేటివ్ టు యూరోప్ అండ్ ఏషియా
if true autocompletion in the run application dialog is made available	నిజమైతే స్వయంచాలకముగింపు నుఅప్లకేషన్ నడుపుము డైలాగ్ నందు అందుబాటు లో ఉంచు
im not good at bringing people to their feet	నేను మనష్యులను చంపి వారి బంధువుల శోకము చూడ లేను
important documents seized	పలు కీలక డాక్యుమెంట్లు స్వాధీనం
woman dies due to electric current	కరెంటు షాక్ తగిలి మహిళ మృతి
then it transcends to art dance performance and music	అప్పుడు సంజ్ఞలు థియేటర్ కధా డ్యాన్స్ మరియు సంగీతంతో కలిపి ఉంటాయి
god asked	అని ప్రశ్నించాడు ఈశ్వరుడు
therefore a healthy lifestyle is a must for a healthy immune system	ఇలా ఆరోగ్యకర దైహిక జీవనానికి నాడీకణ వ్యవస్థ అవసరం ఎంతైనా ఉంది
history repeats	ిస్టరీలు రిపీట్ చేసుకుంటున్నాం
decrease	కు దిగి వస్తున్నాయి
the phones come in prism crush red prism crush black and prism crush white colour options	ప్రిజమ్ క్రష్ రెడ్ ప్రిజమ్ క్రష్ బ్లాక్ ప్రిజమ్ క్రష్ వైట్ రంగుల్లో ఈ మొబైల్ లభిస్తుంది
it is good for health	ఇది అన్ని విధాలా ఆరోగ్యానికి మంచిది
it is totally false	ఇది పూర్తిగా అబద్ధం
virat eyes another record	విరాట్ మరో రికార్డ్
hnahthial town is the administrative headquarters of the district	హన్నాథియల్ పట్టణం జిల్లా పరిపాలనా ప్రధాన కార్యాలయంగా ఏర్పాటు చేయబడింది
best indian batsman	టీం ఇండియా బెస్ట్ బౌలర్స్
it should be completed by	వరకు పూర్తిగా నిర్మూలించాల్సి ఉందన్నారు
the bill was approved by the lok sabha	దీంతో బిల్లు లోక్ సభ ఆమోదం పొందినట్టు సభాపతి ప్రకటించారు
karnataka releases water to telangana	తెలంగాణలోకి ప్రవేశించిన కృష్ణా జలాలు
but the congress had opposed the idea vehemently	అయితే రేవంత్ ఆలోచనని కాంగ్రెస్ లోనే ఓ వర్గం తీవ్రంగా వ్యతిరేకిస్తోంది
he did not further explain	ఆయన అంతకుమించి వివరించలేదు
anganwadi workers salary enhancement	అంగన్వాడీలకు వేతనాల పెంపు
few practise it	కొద్దిమంది ఆచరిస్తారు
player property	ఆటగాడి గుణం
nobody can avoid it	ఎవరూ తప్పించుకోలేనిది
after hollandes statements on rafale deal rahul accuses modi of dishonouring soldiers blood	మనదేశం కోసం ప్రాణాలు అర్పించిన జవాన్ల రక్తాన్ని మోడీ అగౌరవ పర్చారని రాహుల్ ధ్వజమెత్తారు
those guilty should be punished	నేరం చేసిన వాళ్లు శిక్ష అనుభవించాల్సిందే
sweeping allegations	అన్బన్డింగ్ ఆరోపణలు
emergency watch	అత్యవసర అలారం
nda nominee harivansh narayan singh was elected the deputy chairperson of the rajya sabha	తదనంతరం ఆయన ఎన్డీఏ ఉమ్మడి అభ్యర్థి హరివంశ్ నారాయణ్ సింగ్ డిప్యూటీ చైర్మన్గా ఎన్నికైనట్లు ప్రకటించారు
avoid short and tight skirts and sweaters	బిగుతైన దుస్తులు మరియు పొట్టి స్కర్టులు ధరించటం మానేయండి
he did not return home	తిరిగి ఇంటికా రాలేదు
stay out of the danger zone	ప్రమాదప్రాంతం నుండి దూరంగా ఉండండి
farmers group ngo help farmers group in different locations across the city provides fruit vegetables to citizens	రైతు గ్రూపులు ఎన్జిఓ సహాయం నగరంలోని  వేర్వేరు ప్రదేశాలలో  రైతు గ్రూపులు పౌరులకు పండ్లు కూరగాయలను అందిస్తోంది
temperatures hit degree celsius here	గాలి ఉష్ణోగ్రత  డిగ్రీల చేరుకుంటుంది
but heres where it gets tricky	కానీ ఇక్కడ అది కష్టం హక్కును కలిగి ఉంది
thoughts on the allnew hyundai i premium hatchback	కొత్త తరం హ్యుందాయ్ ఐ హ్యాచ్బ్యాక్ టెస్టింగ్పై డ్రైవ్స్పార్క్ అభిప్రాయం
the mobile device market is growing at a huge speed	మొబైల్ పరికరాల కోసం మార్కెట్ వేగంగా పెరుగుతోంది
security forces on duty in kashmir	కశ్మీర్ లోయలో భద్రతా బలగాలు మోహరింపు
madhav was immediately taken to the cbi headquarters for questioning after the arrest	అరెస్ట్ చేసిన వెంటనే మాధవ్ ను సీబీఐ ప్రధానకార్యాలయానికి తరలించారు
she didnt speak for a while	చాలా సేపు అతడు ఏం మాట్లాడలేదు
i know its a risk	రిస్క్ ఉందని నాకు తెలుసు
im ready to be a dad	మొత్తానికి నేను తండ్రిని కాబోతున్నాను
thats the thing about him	అది తనకు సంబంధించిన విషయమని అన్నది
i dont know his name	పూర్తి పేరు ఏమిటీ నాకు తెలియదు
you promise	మీరు వాగ్దానం
bbmp elections are scheduled to be held on saturday aug	ఈనెల వ తేదిన శనివారం బీబీఎంపీకి ఎన్నికలు జరగనున్నాయి
other inventions	మరికొన్ని ఆవిష్కరణలు
every family has an old tradition of cooking	ప్రతి కుటుంబం ఒక పాక సృష్టి సంప్రదాయ ఉంది
hair colour	టెర్రకోట జుట్టు రంగు
hijab or niqab	నేప్ లేదా హిండ్కేక్
zhihao continues because my parents are witnesses we discuss the daily text every morning	జీహావ్ ఇంకా ఇలా చెబుతున్నాడు నా తల్లిదండ్రులు సాక్షులు కాబట్టి మేము ప్రతీరోజు ఉదయం దినవచనాన్ని చర్చిస్తాం
dadasaheb phalke award for amitabh bachchan	అమితాబ్కు దాదాసాహెబ్ ఫాల్కే పురస్కారం
soups are healthy and nutritious	సీఫుడ్ రుచికరమైన మరియు ఆరోగ్యకరమైన ఉంది
jana sena party chief pawan kalyan	జనసేన పార్టీ అధినేత పవన్ కల్యాణ్ ఓ అడుగు ముందుకేశారు
im tired of being taken for a fucking douche	నేను ఎ ఫకింగ్ పిచికారీ కోసం తీసుకున్న అనే అలసిపోతుంది లేదు
superstar mahesh babu is one of the biggest stars in tollywood	టాలీవుడ్ సినిమా ఇండస్ట్రీ లో సూపర్ స్టార్ మహేష్ బాబు వరసగా బ్లాక్ బస్టర్స్ అందుకుంటున్న సంగతి తెలిసిందే
why highrise building	ఎందుకు ఎత్తైన భవనం నిర్మాణ కల
folding method	కుదింపు పద్ధతి
subjects physics chemistry biology economics psychology accountancy mathematics	విభాగాలు మ్యాథ్మెటిక్స్ ఫిజిక్స్ కెమిస్టీ బోటనీ జువాలజీ ఇంగ్లిష్ సంస్కృతం తెలుగు కామర్స్ ఎకనమిక్స్ హిస్టరీ కంప్యూటర్ సైన్స్ హిందీ
keep your arms to the side	చేతులను పక్కకు ఉంచండి
madras high court dismisses case against rajinikanth	రజనీకాంత్ భార్యకు ఝలక్ ఇచ్చిన మద్రాస్ హైకోర్టు
all is set for the zptc and mptc elections in the state on april	ఏప్రిల్ న జరిగిన ఎంపీటీసీ జెడ్పీటీసీ ఎన్నికల్లో కొందరికి అనుకూలంగా పనిచేయాలని అన్నిస్థాయిల్లో ఒత్తిడి వచ్చింది
due to blast the house caught fire	పేలుడు ధాటికి ఇంటిపైకప్పు లేచిపోయింది
you can use the app to	ఇక్కడ మీరు అనువర్తనాన్ని ఉపయోగించవచ్చు
a fight broke out between the two	ఇద్దరి మధ్య పెద్ద గొడవే జరిగింది
the gap between the hindus and the muslims was reduced	హిందువులు ముస్లింల మధ్య దూరం పెరిగింది
the number is rising	కౌంట్ పెరుగుతోంది
whats the agenda	ఎజెండా ఏమిటి
it is not our needs	అది మన అంటుకథకి అనవసరం
rs crore	కోట్లు తేలింది
doctors declared her brought dead	ఆటిజమ్ ఉన్నట్లు డాక్టర్లు నిర్ధారణ చేశారు
tirumala temple file photo	తిరుమల శ్రీవారి ఆలయంఫైల్ ఫోటో
the speaker ordered the disqualification of rebel mlas	మంది తిరుగుబాటు ఎమ్మెల్యేలపై స్పీకర్ అనర్హత వేటు వేశారు
several other studies	కొన్ని ఇతర ఇటీవల అధ్యయనాలు
nevertheless she persisted submitting a new application only to receive a second refusal in	ఒక మహారాణి బైబిలుపట్ల ఆసక్తి చూపిస్తుంది
kaithi starring karthi in a lead role is an action thriller directed by lokesh kanagaraj	తమిళ దర్శకుడు లోకేష్ కనగరాజ్ దర్శకత్వంలో కార్తి ప్రధాన పాత్రలో తెరకెక్కిన సినిమా ఖైదీ
he picked three wickets in his four overs	వరుస ఓవర్లలో మూడు వికెట్లు తీసి ఔరా అనిపించుకున్నాడు
the incident occurred on tuesday at yelamblasa village of kadur taluk in chikkamagaluru	చిత్తూరు జిల్లా పలమనేరు మండలం మొరం పంచాయతీ నక్కపల్లిలో బుధవారంనాడు ఆ ఘటన చోటు చేసుకుంది
the first rs	మొదటి మేళాలో రూ
christmas fruit cake	క్రిస్మస్ ఫ్రూట్ కేక్ప్లమ్ కేక్
growing up is important to a child but more than physical growth is desired	వారు మానసికంగా భావోద్వేగపరంగా కూడా ఎదగాలని ఆశిస్తాము
child abuse	పిల్లలపై వివక్ష
however the rs	అయితే అనుకున్న పని కాకపోవడంతో తీసుకున్న మొత్తంలోనుంచి రూ
if you wish to know more then read on	మరిన్ని విషయాలను తెలుసుకోవాలని ఉందా అయితే మరెందుకు ఆలస్యం చదివేయండి
treatment for breast cancer	రొమ్ము క్యాన్సర్ చికిత్స
cpu count	కౌంట్
dont regret the expenses	మీరింక ఏ ఖర్చులు పెట్టొద్దు
i cannot pretend i am sorry he is gone	ఇదంతా తెలుసు కనుక నేను పోయిన వాటి కొరకు దుఃఖించడం లేదు
get out now	ఇప్పుడు పొందండి
nivetha thomas plays the second leading lady	లీడ్ హీరోయిన్గా నివేధా థామస్ నటిస్తోంది
but you cant get away	కానీ దూరంగా పొందలేము
congress protests against giriraj singhs comments	కాగా గిరిరాజ్ సింగ్ వ్యాఖ్యలపై కాంగ్రెస్ పార్టీ మండిపడుతుంది
waiting for it	అని ఎదురు చూసే
agriculture should become profitable in telangana	తెలంగాణలో వ్యవసాయం లాభసాటిగా మారాలన్నారు
he is being severely trolled on social media	సోషల్ మీడియాలోను ఆయనపై మండిపడుతున్నారు
category fusion	వర్గం  డేంజరస్
why the heart	హృదయం ఎందుకు
krishna was dark	కృష్ణయ్యకు చుక్కెదురైంది
it has submitted the report	దీనిపై నివేదిక అందించింది
among the firms to be delisted are binaca synthetic resins canvay chemicals chetak spintex global industries karan finance mahendra cements manav pharma maruti organics rams transformers regent chemicals rohini strips sarla credit securities sunrise zinc thapar exports and vishal chairs	ఇలా డీలిస్ట్ అవుతున్న సంస్థల్లో బినాకా సింథటిక్ రెసిన్స్ కానే్వ కెమికల్స్ చేతక్ స్పింటెక్స్ గ్లోబల్ ఇండస్ట్రీస్ కరణ్ ఫైనాన్స్ మహేంద్ర ఫైనాన్స్ మానవ్ ఫార్మా మారుతి ఆర్గానిక్స్ రామ్స్ ట్రాన్స్ఫార్మర్స్ రెజెంట్ కెమికల్స్ రోహిణి స్ట్రిప్స్ సరళా క్రెడిట్స్ అండ్ సెక్యూరిటీస్ సన్రైజ్ జింక్ థాపర్ ఎక్స్పోర్ట్స్ విశాల్ చైర్స్లాంటివి ఉన్నాయి
such initiatives may make a big difference in the life of a fellow believer prov	అలాంటి సహాయం మన సహోదరసహోదరీలకు నిజంగా ఎంతో ఉపయోగపడవచ్చు  సామె
we are paying for them	మనం వాటికి డబ్బు చెల్లిస్తున్నాం
the kavaratti aquarium has a rich collection of corals and a vast collection of tropical fish specimens	కవరట్టి మత్స్య ప్రదర్శనశాల జలజీవశాలలో పగడాల గొప్ప సేకరణ ఉష్ణమండల చేపల నమూనాల విస్తారమైన సేకరణ ఉంది
an inquiry has already begun	ఇప్పటికే దర్యాప్తు ప్రారంభించామని తెలిపారు
roasted food	జంక్ ఫుడ్
folder owner	సంచయం యజమాని
friendship turned into love	స్నేహం ప్రేమగా మారింది
additional ndrf teams airlifted	రాష్ట్రానికి అదనంగా  ఎన్డీఆర్ఎఫ్ బృందాలు
isro has successfully launched satellites simultaneously into space	అన్ని దేశాలూ అబ్బురపడేలా ఒకేసారి  ఉపగ్రహాలను అంతరిక్షంలోకి విజయవంతంగా ఇస్రో ప్రవేశపెట్టడం ఓ అద్భుతం
the exam is conducted in three phases which includes a preliminary test a mains exam and lastly the personality test	ఈ పరీక్ష మూడు అంచెలలో జరుగుతుంది అవి ప్రిలిమినరీ పరీక్ష మెయిన్ పరీక్ష తరువాత ఇంటర్వూ అభ్యర్ధి ప్రతీ అంచెలోనూ సాధించిన మార్కులను కలిపె తుది జాబితాను ఎంపిక చెస్తారు
these diseases fall in two categories	ఈ వ్యాధి రెండు
srmg operates in seven countries	షార్ప్ అమెరికాలో సైతం పనిచేశారు
the tragic incident took place in nagar kurnool district	ఈ అత్యంత విషాద ఘటన కర్నూలు జిల్లాలో చోటుచేసుకుంది
indian navy personnelonboardins vikramadityaoff karwar expressed their appreciation by forming a human word chain in thanking the corona warriors southern naval command	కర్వార్ ప్రాంతంలో నిలిపిన ఐఎన్ఎస్ విక్రమాదిత్య పై నుంచి భారత నౌకాదళానికి చెందిన నావికులు మానవ హారంగా ఏర్పడి కృతజ్ఞతలు తెలిపారు
rajinikanth prabhu and mohan babu	రజినీకాంత్ మోహన్ బాబు
highways are being built all over the country	దేశంలోని ప్రతి గ్రామానికి రోడ్డు నిర్మాణం జరుగుతుంది
she is taking off to london	ఆమె లండన్ వెళ్లారు
i didnt expect him go so soon	ఆమె ఇంత త్వరగా వెళ్లిపోతారని అనుకోలేదు
road safety first	రోడ్ సేఫ్టీని ప్రాధాన్యతాంశంగా తీసుకోవాలి
the match was drawn	దాంతో మ్యాచ్ డ్రా అయింది
change system time	సిస్టమ్ సమయాన్ని మార్చుము
how should one choose makeup	ఎలా ఒక దిండుమసాజ్ ఎంచుకోవడానికి
users can access observed weather forecasts radar images and be proactively warned of impending weather events	వాతావరణం అంచనాలు రాడార్ చిత్రాలను ప్రజలు చూసే వెసులుబాటు వాతావరణ పరిస్థితులపై ముందుగానే హెచ్చరికలు
no such industry exists	ఈ తరహాలో తయారయ్యే ఇండస్ట్రీ లేదట
the bus driver parked the vehicle across the road blocking the highway	ొడవ పెద్దది అవుతుండటంతో డ్రైవర్ బస్సును రోడ్డు పక్కన ఆపాడు
the bse sensex plunged points or per cent to	బిఎస్ఇ సెన్సెక్స్  పాయింట్ల నష్టంతో శాతంతో  వద్ద ముగిసింది
wish you all the luck in life	జీవితంలో అదృష్టం
the bus overturned	దీంతో బస్సు బోల్తాపడింది
while veteran producer shyam prasad reddy switched on the camera anil ravipudu directed the first shot	తొలి సన్నివేశానికి నిర్మాత అల్లు అరవింద్ క్లాప్ కొట్టగా శ్యామ్ ప్రసాద్ రెడ్డి కెమెరా స్విచ్చాన్ చేశారు వివివినాయక్ గౌరవ దర్శకత్వం వహించారు
she was admitted to the government hospital	దీంతో ఆమెను భద్రాచలంలోని ప్రభుత్వ హాస్పిటల్ కు తీసుకువెళ్లారు
whats in the offing	వీడిలో ఉన్నది ఏంటి
colds and allergies are the most common causes of rhinitis	అలెర్జీలు జలుబు వల్ల ఎక్కువగా సైనసైటిస్ సమస్య ఏర్పడుతుంది
the latest images reveal the interior of the tata x hatchback as we can see the steering wheel instrument cluster and other details of the dashboard	టాటా ప్రతినిధులు తాజాగా టాటా ఎక్స్ హ్యాచ్బ్యాక్ కారును పరీక్షిస్తుండగా పలు ఇంటీరియర్ మరియు ఎక్ట్సీరియర్ ఫోటోలను రహస్యంగా సేకరించారు
yugal bihari inter collegepw	యుగల్ బిహారీ ఇంటర్ కాలేజ్పిడబ్ల్యు
it is not true	ఆ వార్తల్లో నిజం లేదు
supreme court has awarded rs	సుప్రీం జడ్జికి రూ
respectively	గా నిర్ణయించారు
patients suffer	నానా ఇబ్బందులు పడుతోన్న రోగులు
nickhil mani	నిక్కీ మినాజ్
dont drink alcohol then drive	మద్యం సేవించి వాహనాలు నడపరాదు
it was not our best day	మనం హాయిగా నవ్వుకోని రోజు వృథాగా గడిచిపోయినట్లే
at present he is recuperating in a private hospital of nagpur	దీంతో వారు నాగపూర్ లోని ఓ ప్రైవేటు ఆసుపత్రిలో చికిత్స పొందుతున్నారు
i dont think it hindered me	ఇది నన్ను గాయపరుస్తుందని అనుకోవడం లేదు
right sir	కుడి సర్
rs crore	రూ  లక్షల కోట్లు
an idea of home	ఇంట్లోంచి పుట్టిన ఆలోచనే
scott disick and sofia richie	సోఫియా రిచీ మరియు స్కాట్ డిసిక్
im trying to gain a lot of weight	నేను బరువు తగ్గడానికి చాలా ప్రయత్నిస్తున్నాను
its priced at rs	ల ధర వద్ద తీసుకువచ్చింది
i was interested in films	సినిమాలపై ఆసక్తితోనే
he was rushed to the local hospital	వెంటనే అతడు స్థానికంగా ఉన్న ఆసుపత్రికి పరుగులు తీశాడు
congress delayed its decision on supporting the shiv sena for government formation	ప్రభుత్వాన్ని ఏర్పాటు చేసేందుకు శివసేనకు మద్దతు ఇవ్వాలని కాంగ్రెస్ పార్టీ హైకమాండ్ నిర్ణయించింది
crores	కోట్లకు అమ్మారు
lalu cannot contest elections	ఎన్నికలలో పోటీ చేయడు కాబట్టి
until recently	ఇటీవల వరకు
jehovah provides food for every living thing	ప్రతిజీవికి  యెహోవా ఆహారాన్ని అందిస్తున్నాడు
cbi was asked to investigate	సీబీఐ దర్యాప్తుకు డిమాండ్ చేశారు
the event was attended by pm modi	ఈ కార్యక్రమానికి ప్రధాని మోడీ హాజరయ్యారు
then wash off	తర్వాత వడగట్టుకోవాలి
karnataka over of covid patients in state are asymptomatic	కర్ణాటక రాష్ట్రంలోని కోవిడ్  రోగులలో  శాతానికిపైగా ఎలాంటి లక్షణాలూ కనిపించనివారేనని తేలింది
the gandhari people are a tribe mentioned in the rigveda the atharvaveda and later vedic texts	గాంధార ప్రజలు ఋగ్వేదం అధర్వవేదం తరువాత వేద గ్రంథాలలో పేర్కొన్న తెగగ ఉంది
add salt pepper and mix well	తర్వాత అందులో మిరపపొడి ఉప్పు వేసి బాగా కలుపుకోవాలి
thats the beauty	దట్స్ ది బ్యూటీ
dont you ever feel like giving up	మీకు ఏ దశలోనూ రిటైర్ అవ్వాలని అనిపించలేదా
hyderabad metro rail services came to a halt in the city	సాక్షి హైదరాబాద్ సిటీ బస్సుల రద్దుతో హైదరాబాద్ నగరంలో మెట్రో రైళ్లు కిటికిటలాడుతున్నాయి
i cannot see	నాకు కనిపించడంలేదండిఅంటూ ఆందోళన పడింది జయ
mercedesbenzs june sales indicate a steady growth	అలాగే గడచిన నెల విక్రయాలలో మెర్సిడెస్ బెంజ్ ప్రోత్సాహకర వృద్ధిని కనబరిచింది
i therefore adopted the phrase civil resistance	నేను చూసిన తొలి సినిమా వీరాంజనేయ యుద్ధం అని గుర్తు
but hurts	కానీ బాధ పెడతాయి
the music was given by ilaiyaraja	ఇళయరాజా సంగీతం అందించాడు
the strike has disrupted bangalore metropolitan transport corporation bmtc services in bengaluru and karnataka state road transport corporation ksrtc services in rest of karnataka	కర్ణాటక రోడ్డు రవాణా సంస్థకేఎస్ఆర్ టీసీ బీఎంటీసీ బెంగళూరు సిటీ బస్సులు సేవలు పూర్తిగా నిలిచిపోయాయి
or ysrcp	లేక వైసీపీ ఏజెంటువా
the writer is on the faculty of jawaharlal nehru university	రచయిత చరిత్రకారిణి జవహర్లాల్ నెహ్రూ యూనివర్సిటీలో ప్రొఫెసర్గా పనిచేశారు
the china growth	చైనా వృద్ధి దూకుడు
the asian games	ఆసియా గేమ్స్లో తొల
naidu is married to balakrishnas sister and their son lokesh is married to balakrishnas daughter brahmini	బాలకృష్ణ కూతురు బ్రాహ్మణిని లోకేష్ పెళ్లి చేసుకున్నారు
fighting till the end	చివరి వరకు పోరాడుతాం
china sales	చైనీస్లో మార్కెటింగ్
benefits up to rs	వరకు బెనిఫిట్ పొందొచ్చు
opportunities for women	మహిళలకు సౌలభ్యం
bible for boys	పిల్లలు కోసం బైబిల్ వెర్సెస్
we are	మనమే వున్నాం
records tumble	రికార్డులు బద్దలు
need a job	పని అవసరమైన కోరిక ఉంది
he asked	సూటిగా అడిగేశాడు
flickering lights reflected on gold and colored glass tesserae created an aura of mysticism	తరచూ బైబిలు కథలు చిత్రీకరించబడే అలాంటి మొజాయిక్లు ఆరాధకులకు ఉపదేశించడానికి పనికొచ్చేవి
the government further asked state governments to promote decentralised marketing and procurement of farm commodities at village level	గ్రామీణ స్థాయిలో వికేంద్రీకరణ మార్కెటింగ్ వ్యవసాయోత్పత్తుల సేకరణను ప్రోత్సహించాలని కేంద్ర ప్రభుత్వం రాష్ట్ర ప్రభుత్వాలను కోరింది
and rs	చెలామణిలో లేని పాత రూ
the proposal is intended to double the income of the farmers	రైతుల ఆదాయాన్ని రెట్టింపు చేయటం లక్షంగా ప్రకటించారు
the bjp aims to win a majority of the seats in the region during the forthcoming general elections	ఎన్నికల్లో ఈ జిల్లా నుండి ఎక్కువ సంఖ్యలో అసెంబ్లీ స్థానాలను కైవసం చేసుకోవాలని టిడిపి ప్లాన్ చేస్తోంది
ill give you	నేను అందిస్తాను
well settled family	బాగా స్థితిమంతులైన కుటుంబం
i know i havent done anything wrong	నేనే తప్పు చేయలేదన్న సంగతి నాకు తెలుసు
the madhya pradesh assembly has members currently	మధ్యప్రదేశ్ అసెంబ్లీలో  సీట్లు ఉన్నాయి
over rs	మించి డబ్బులు ఉండకూడదు
the reason is still unknown	కారణం ఇప్పటికి కూడా ఎవరికి తెలియదు
risk factors for stroke	స్ట్రోక్ ప్రమాద కారకాలు
is up	పెంచటం గమనార్హం
thereafter a colourful cultural programme was presented by the students	అనంతరం విద్యార్థినులు ప్రదర్శించిన సాంస్కృతిక కార్యక్రమాలు అందరినీ అలరించాయి
its a tradition	అది ఒక సంప్రదాయం
craving is natural	కలి అనుకోవడం సహజమే
it secretary jayesh ranjan	ఐటిశాఖ కార్యదర్శి జయేష్ రంజన్
he has insulted the sentiments of hindus	హిందువుల మనోభావాలను దెబ్బతీసేలా వ్యాఖ్యానించారంటూ మండిపడ్డారు
testing and screening	టేస్టింగ్ మరియు పరీక్ష
eliminates constipation and gas problems	కడుపుబ్బరాన్ని గ్యాస్ సమస్యలను నివారిస్తుంది
for farmers rs	అరటి తోటలు నష్టపోయిన రైతులకు ఎకరా ఒక్కింటికి రూ
it can be divided into three sectors	వారు మూడు విభాగాలుగా వేరు చేయవచ్చు
in the last hours yanam and anakapally recorded cm rainfall	గడిచిన  గంటల్లో భీమిలిలో  సెంమీ సాలూరు వెంకటగిరి కోటలో  సెంమీ వర్షపాతం నమోదైంది
health and motor third party insurance policyholders allowed to make premium payments till may th which are due for renewal during lockdown	ఆరోగ్య వాహన తృతీయపక్ష బీమా నవీకరణ గడువు దిగ్బంధ కాలంలో ముగిసేట్లయితే పాలసీదారులకు మే దాకా రుసుము చెల్లించే వెసులుబాటు
she was taken to rajawadi hospital	ఆమెను రాజాముత్తయ్య మెడికల్ కాలేజీ ఆస్పత్రికి తరలించారు
earn rs	రూ కోటి గెలుచుకోండి
or would a true worshipper lift up a glass of wine and ask for a divine influence on someone or a blessed future for him	యిర్మీయా    ఒకరి భవిష్యత్తును దేవుడు ఆశీర్వదించాలని లేదా ఆయనకు సంతోషకరమైన భవిష్యత్తు ఉండాలని సత్యారాధకుడు తన ద్రాక్షారసపు గ్లాసులు పైకెత్తి కోరగలడా
pakistan election rally	పాక్ ఎన్నికల్లో రిగ్గింగ్
cases are increasing day by day	రోజురోజుకు కేసుల సంఖ్య భారీగా పెరుగుతోంది
some are ready other underconstruction	కొన్నిటి నిర్మాణం పూర్తి కాగా కొన్నిటి నిర్మాణం చివరి దశలో ఉన్నాయి
nifty psu bank index gained over per cent	నిఫ్టీ పిఎస్యు బ్యాంకు ఇండెక్స్ శాతంపైగా లాభపడింది
she is concealing the facts	పైగా వాస్తవాలను దాచిపెడుతున్నారు
however the centre did not yield	ఆయినప్పటికీ కేంద్రం దిగి రాలేదు
then try it here at dzongu	జొంగులో ప్రయత్నించండి
the hospitals condition is very bad	ఆసుపత్రులు దయనీయ స్థితిలో ఉన్నారన్నారు
need more	అంతకంటే ఇంకేంకావలి
after the incident the students organisation staged a sitin protest in front the school demanding action against the teacher	ఈ ఘటన తర్వాత విద్యార్థి సంఘాలు కాలేజీ ముందు ధర్నాకు దిగింది
he is being investigated by both the cbi and the ed in the matter	ఈ రెండు కేసుల్లో అటు సీబీఐ ఇటు ఎన్ ఫోర్స్ మెంట్ డైరెక్టరేట్ ఈడీ అధికారులు ఆయనను విచారిస్తున్నారు
the number of deaths has increased	ఇటు మృతుల సంఖ్య కూడా పెరిగింది
so far rs	ఇప్పటి వరకు ఈ చిత్రానికి రూ
_remove bookmark	ఇష్టాంశాన్ని తీసివేయి
it is the one who is bringing forth the army of them even by number all of whom he calls even by name	వీటి లెక్కచొప్పున వీటి సమూహములను బయలుదేరజేసి వీటన్నిటికిని పేరులు పెట్టి పిలుచువాడే గదా
rahul attacks pm on rising petrol diesel prices	పెట్రోల్ డీజిల్ ధరల పెంపు కోసమే అన్లాక్  రాహుల్
shreyas iyer won the toss and delhi opted to bat first	టాస్ గెలిచిన డిల్లీ సారథి శ్రేయస్ అయ్యర్ తొలుత బ్యాటింగ్ ఎంచుకున్నాడు
she has worked in more than films	అంతేకాకుండా కి పైగా చిత్రాలలో హీరోగా నటించాడు
decrease	వరకు తగ్గింపును అందించారు
the body was shifted to gandhi hospital for postmortem	మౌనిక మృతదేహాన్ని గాంధీ ఆస్పత్రికి తరలించారు
in the general case of a particle moving in the plane the orbital angular velocity is the rate at which the position vector relative to a chosen origin sweeps out angle	సాధారణ సందర్భంలో ఒక తలంలో కదులుతున్న కణానికి ఎంచుకున్న మూలానికి సంబంధించి స్థాన సదిశ స్వీప్ అవుట్ కోణ రేటును కక్ష్యా కోణీయ వేగం అంటారు
pm narendra modi extended greetings on the occasion of indian air force day	ఈ సందర్భంగా ప్రధాని మోడీ వైమానిక దళానికి శుభాకాంక్షలు తెలిపారు
the result of tests is awaited	ఇందులో ఇంకా  మంది శాంపిల్స్ కు సంబంధించిన ఫలితాలు రావాల్సి ఉంది
cabinet decision	కేబినెట్ నిర్ణయం
zorawar nandwal class v delhi public school bathinda	సందీప్ పదో తరగతి జవహర్ నవోదయ విద్యాలయ వరంగల్
he went on to deliver wry commentary on international programming in such shows as clive james on television	క్లైవ్ జేమ్స్ ఆన్ టెలివిజన్ వంటి ప్రదర్శనలలో ఇంటర్నేషనల్ ప్రోగ్రామింగ్పై వ్యంగ్యంగా వ్యాఖ్యానం చేస్తూ ఆయన గుర్తింపు తెచ్చుకున్నారు
otherwise he feels shaken	కాకపోతే బోర్ ఫీలవుతున్నాడు
for every rs	డిపాజిట్ చేసిన ప్రతి రూ
the ink has dried	చిక్కుడు వాగు ఎండిపోయింది
music is by anirudh ravichander	అనిరుధ్ రవిచందర్ మ్యూజిక్
are you planning to take a home loan	గృహ రుణం తీసుకోవాలని ప్రయత్నిస్తున్నారా
caste and communities	గృహాలు మరియు కమ్యూనిటీలు
heavy rains	ఈదురుగాలులతో భారీ వర్షం
kind of films in future	భవిష్యత్తులో ఎలాంటి సినిమాలు చేయాలని ఉంది
sita is directed by teja	సీత సినిమాకు తేజ దర్శకత్వం వహిస్తున్నారు
hes a very normal guy	అతను చాలా సాధారణ వ్యక్తి
she was the bjps candidate	ఆమె బీజేపీ అభ్యర్థి చేతిలోనే ఓడిపోయింది
it was never free	ఎప్పుడు స్వేచ్ఛ లేదన్నారు
the ongoing strike by the medical practitioners entered its fifth day in west bengal	పశ్చిమబెంగాల్లో జూనియర్ వైద్యుల సమ్మె నాలుగో రోజుకు చేరింది
the marine aquarium and research centre marc is a great place for kids to enjoy an afternoon	మార్క్ మధ్యాహ్న సమయాలను గడపడానికి పిల్లలకు ఎంతో మంచి ప్రదేశం
cpr or cardiopulmonary resuscitation is an emergency procedure usually performed when a person gets a sudden cardiac arrest and his heart stops beating	హృదయశ్వాసకోశ పునరుజ్జీవన చర్య    కార్డియోపల్మోనరీ రిససిటేషన్    సీపీఆర్ అనగా వ్యక్తి యొక్క గుండె కొట్టుకోవడం స్తంభించినప్పుడు లేదా ఊపిరితిత్తులు శ్వాస తీసుకోని స్థితిలో ఉన్ననప్పుడు వెంటనే ఆ చర్యల పునరుద్ధరణకు చేయు అత్యవసర ప్రక్రియ
it constituted per cent of the total cash in circulation	ఇది మొత్తం నగదు చెలామణిలో  శాతం
madhubala was one of the finest actors in bollywood	బాలీవుడ్ చరిత్రలోని గొప్ప నటీమణుల్లో మధుబాల ఒకరు
delhi is already facing the longest cold wave in the month of december in years	డిసెంబర్ నెలలోనే ఈ స్థాయిలో ఉష్ణోగ్రతలు పడిపోవడం గత  సంవత్సరాల్లో ఢిల్లీ ఇప్పుడే చూస్తోంది
the same thing happened in america	ఇలాంటి ఘటన అమెరికాలో చోటుచేసుకుంది
then everything went black	అప్పుడు అంతా చీకటి
jp nadda elected as new bjp chief	బీజేపీ కొత్త జాతీయాధ్యక్షుడిగా జేపీ నడ్డా  ఎన్నిక ఏకగ్రీవం
the apple iphone gb is priced rs	యాపిల్ ఐఫోన్ ఎస్ జీబి ధర రూ
im working on three telugu films	తెలుగులో మూడు సినిమాలు చేస్తున్నాను
protesting is a right of the citizen	నిరసనలు చేయడం పౌరుల హక్కు అని వ్యాఖ్యానించారు
he has demanded a judicial inquiry into the incident	ఈ వ్యవహారంపై సిట్డింగ్ జడ్జితో న్యాయ విచారణ జరిపించాలని ఆయన డిమాండ్ చేశారు
the government spends rs	ప్రభుత్వం మాత్రం ఎకరాకు రూ
he joined the socialist movement and was elected secretary of the district praja socialist party psp ballia	అతను సోషలిస్టు ఉద్యమంలో ప్రజా సోషలిస్టు పార్టీ  కి సెక్రటరీ గా నియమితుడయ్యాడు
please correct it	దయచేసి సవరించగలరు
us mexico and canada to host world cup fifa	ఫిఫా వరల్డ్కప్ ఆతిథ్య హక్కులను దక్కించుకున్న అమెరికా కెనడా మెక్సికో
but he did decide	అయినా అతను నిర్ణయం తీసుకున్నాడు
for every rs	ఒక్కో ఆటకు రూ
regular exercise	క్రమం తప్పకుండా వ్యాయామం
beautician padma is undergoing treatment at vijayawada government hospital	తీవ్రగాయాలైన పద్మ విజయవాడ అసుపత్రిలో చికిత్స పోందుతోంది
his father died young his mother was a nag	వన్య తండ్రి యువ మరణించాడు అతని తల్లి పెరిగాడు
do you wish to face the camera again	నవరసాలు పలికిస్తూ కెమెరాను ఫేస్ చేయాలనుకుంటున్నారా
the government emarketplace provides an equitable opportunity to startups to offer their services and products to all govt enterprises across the country he added	ప్రభుత్వ ఇమార్కెట్ ప్లేస్ స్టార్టప్లకు తమ సేవలను మరియు ఉత్పత్తులను దేశవ్యాప్తంగా ఉన్న అన్ని ప్రభుత్వ సంస్థలకు అందించడానికి సమానమైన అవకాశాన్ని కల్పిస్తుంది  అని తెలిపారు
forms a new party	తనో కొత్త పార్టీ పెడతాడు
crore rs	వేల కోట్ల ఆదాయం రూ
she agrees to his offer	తన ప్రతిపాదనను శ్రుతి అంగీకరిస్తుంది
crore	కోట్లు ఖర్చుపెట్టింది
the wicket is good	దుబారు వికెట్ బాగుంది
its sad	ంటూ బాధగా అంటుంది
but never did he utter a word about policy	అయితే ఆయన ఎప్పుడూ రాజకీయాల గురించి ఓపెన్గా ప్రస్తావించలేదు
everything stopped	అన్ని నిలదీశారు
pandya commented hahaha love you on the picture	ఇక ఆ ఫోటోకు హాహా ఐ లవ్ యూ అని హర్దిక్ పాండ్యా కామెంట్ పెట్టాడు
but her friends are worried	కానీ ఆమె విసుగును స్నేహితులు
here is an exciting news for mega fans	మెగా అభిమానులకు జోష్ కలిగించే మరో వార్త
the movie is directed by ks ravi kumar and produced by c kalyan	ఈ సినిమాకి కే యస్ రవికుమార్ దర్శకత్వం వహించగా సీ కళ్యాణ్ సినిమాని నిర్మించారు
gujarat is on first place	మొదటి స్థానంలో గుజరాత్ నిలిచింది
the objective of both the factions is same	రెండు గుంపుల గమ్యం ఒక్కటే
powerful women	శక్తివంతమైన మహిళలు
candidates can download their admit card by providing their registration id roll number name and date of birth	అభ్యర్థులు తమ రూల్ నెంబర్ లేదా రిజిస్ట్రేషన్ నెంబర్ పాస్వర్డ్ లేదా పుట్టిన తేదీ వివరాలను సమర్పించి హాల్టికెట్లను డౌన్లోడ్ చేసుకోవచ్చు
generally a copy is saved for later reference	సాధారణంగా ఒక లీటరు నుండి లీటరున్నర వరకు నీటిని తీసుకోవాలని సూచిస్తారు
the new development bank the currency reserve arrangement strategy for brics economic cooperation these are clear evidence of our vision and our resolve	బ్రిక్స్ దేశాలు ఏర్పాటు చేసుకున్న కొత్త అభివృద్ధి బ్యాంకు కరెన్సీ రిజర్వ్ బ్రిక్స్ ఆర్థిక సహకార వ్యూహం మనందరి ఉమ్మడి కట్టుబాటుకు ఉమ్మడి దిశకు నిదర్శనం
even people	సామాన్యులకు కూడా
because it is the essence of democracy	ఎందుకంటే ఇది ప్రజాస్వామ్యానికి సంబంధించింది
crore	కోట్లు గిరిజనులకు పోషకాహారాన్ని సమకూర్చేందుకు ఫుడ్ బాస్కెట్లకు రూ
come come	చాలింక రా
rajs face glowed	రాజారావు ముఖం విప్పారింది
but it was devastating	కానీ అది దారుణంగా బెడిసికొట్టింది
manimuthusamy vetrivel	మణిమూర్తి వడ్లమాను
thats for the movies	ఇది సినిమాలకి సంబందించినది మాత్రమే
it can all be done	వన్నీ చేయొచ్చు
one person was killed and five others sustained serious burn injuries in the incident	ఈ ఘటనలో ఒకరు మృతిచెందగా ఐదుగురికి తీవ్ర
kangana ranaut and rajkummar rao play their characters to near perfection	కంగనా రనౌత్ రాజ్ కుమార్ రావు తమ పెర్ఫార్మెన్స్తో అదరగొట్టారు
towards polavaram project rs	పాలమూరురంగారెడ్డి ప్రాజెక్ట్ పూర్తయితే ఏడాదికి రూ
the muchawaited third season of reality show bigg boss telugu has begun and has already completed a successful week on the air	తెలుగులో వచ్చిన బిగ్గెస్ట్ రియాలిటీ షో గా గుర్తింపు తెచ్చుకున్న బిగ్ బాస్ రెండో సీజన్ కు సన్నాహాలు ఊపందుకున్నాయి
dabangg actor salman khan is a popular bollywood actor	కండల వీరుడిగా గుర్తింపు పొందిన బాలివుడ్ నటుడు సల్మాన్ ఖాన్ భవితవ్యం నేడు తేలనున్నది
our family united at last	జీవిత కథ
the number of coronavirus cases in the country are rising day by day	దేశంలో నమోదవుతున్న కరోనావైరస్ కేసుల సంఖ్య రోజురోజుకి పెరుగుతోంది
best known films	అత్యంత ప్రసిద్ధ సినిమా పాత్రలు
actor pawan kalyan who was the star campaigner for the bjptdp alliance has lashed out at the trs president k chandrashekar rao	తెలుగు రాష్ట్రాల్లో ఎన్నికలు జరిగే సమయంలో సినీ నటుడు జనసేన పార్టీ అధ్యక్షుడు పవన్ కళ్యాణ్ టీఆర్ఎస్ పార్టీకి కెసిఆర్ కి వ్యతిరేకంగా బీజేపీటీడీపీ కూటమికి మద్దతుగా ప్రచారం చేసిన సంగతి తెలిసిందే
apple iphone enters more countries	మరో దేశాల్లో యాపిల్ ఐఫోన్  ప్లస్
using her height to full advantage sindhu displayed a sterling performance to script a win against former world no and london olympics silver medallist wang yihan to enter the semis	ఈ ఒలింపిక్స్ లో తొమ్మిదో సీడింగ్ గా బరిలోకి దిగిన సైనా   తేడాతో వాంగ్ను మట్టికరిపించింది
experts are	ిపుణుల్లో ఉంది
birth and early life	పుట్టిన మరియు ప్రారంభ జీవితం
radhakrishna vikhe patil leader of opposition in the maharashtra legislative assembly	మహారాష్ట్ర అసెంబ్లీలో ప్రతిపక్ష నేత రాధాకృష్ణ విఖేపాటిల్ చర్చను ప్రారంభించారు
rahul unsparing in his criticism of modi	మోడీ గుండెల్లో పేదలుకు చోటు లేదని రాహుల్ విమర్శ
after billionaire jeweller nirav modi fled the country to escape facing the law for his alleged involvement in the rs crore punjab national bank pnb fraud the whole nation seems to be asking where is nirav modi or nimo	న్యూఢిల్లీ పంజాబ్ నేషనల్ బ్యాంకులో వేల కోట్ల కుంభకోణానికి పాల్పడి విదేశాలకు పారిపోయిన నగల వ్యాపారి నీరవ్ మోడీ ఇప్పుడు కేసు నుంచి తప్పించుకోవడంపై దృష్టి సారించినట్లు తెలుస్తోంది
anil ambanis rcom owes money to china development bank exim bank of china industrial and commercial bank of china	ఆర్కామ్కు రిలయన్స్ టెలికాంకు చైనా డెవలప్మెంట్ బ్యాంక్ ఎక్స్పోర్ట్ ఇంపోర్ట్ బ్యాంక్ ఆఫ్ చైనా ఇండస్ట్రియల్ అండ్ కామర్స్ బ్యాంక్ ఆఫ్ చైనాలు కూడా అప్పులు ఇచ్చాయి
congress mla nitesh rane and his supporters throw mud on engineer prakash shedekar	ఎమ్మెల్యే నితేశ్ రాణా ఆయన మద్దతుదారులు ఇంజినీర్ ప్రకాశ్ షెడేకర్పై బకెట్ల ద్వారా బురదను పోశారు
jayalalithaas condition continues to improve says hospital	అనారోగ్యంతో ఉన్న జయలలిత కోలుకుంటున్నారని ఆయన తెలిపారు
jesus truly is as paul wrote king of those humans who rule as kings and lord of those humans who rule as lords	పౌలు వ్రాసినట్లుగా యేసు నిజంగానే మానవ రాజులకు రాజును మానవ ప్రభువులకు ప్రభువునై యున్నాడు
ford mustang	సంవత్సరానికి చెందిన ఫోర్డ్ మస్టాంగ్ కారు
select the atm card and click on proceed button	ఏటీఎమ్ కార్డును ఎంచుకుని ప్రొసీడ్ బటన్ను క్లిక్ చేయాలి
three maoists killed in jharkhand gunfight	జార్ఖండ్లో ముగ్గురు మావోయిస్టుల మృతి
but in a dental surgeon named william morton opened the way to the widespread use of anesthetics in surgery	కానీ లో విలియమ్ మోర్టన్ అనే దంతవైద్యుడు శస్త్రచికిత్సలో మత్తిచ్చే ప్రక్రియను విస్తృతం చేసేందుకు మార్గాన్ని తెరిచాడు
the problem is largely in the north and central karnataka districts	ఉత్తర మధ్య కర్ణాటకలోనే సమస్య అధికంగా ఉంది
do you invest in mutual funds	మొత్తం మ్యూచువల్ ఫండ్లలో పెట్టమంటారా
do you need physical training	నీకీ శిక్షణ అవసరమా
he wasnt even married	అయినా అతనికి పెండ్లి కాలేదు
david warner allu arjun butta bomma	అల్లు అర్జున్ పోజ్ లో సిత్తరాల సిరపడు అంటున్న డేవిడ్ వార్నర్
tested efficiency for the manual version is km per litre and for the automatic it is kilometre per litre	మ్యానువల్ ట్రాన్స్ మిషన్ తో పనిచేసే వేరియంట్లయితే లీటరుకు  కిలోమీటర్లు ఆటోమేటిక్ ట్రాన్స్ మిషన్ వాహనాలైతే  కిలోమీటర్ల వరకు మైలేజినిస్తుంది
pooja hegde acted as the lead actress and sushant tabu jayaram navdeep murali krishna and rajendra prasad played key roles in the celluloid	పూజ హెగ్డే హీరోయిన్ గా నటించడం టబు జయరాం సుశాంత్ నవదీప్ సునీల్ సముద్ర ఖని రాజేంద్ర ప్రసాద్ మొదలు స్టార్ నటీనటులు ఈ సినిమాలో నటించడం
psychiatric symptoms	మానసిక అనారోగ్యం చిహ్నాలు
she was an actress in telugu serials	తనని నటిగా తెలుగు సినిమాల్లో నిలబెట్టింది
its not about age	అది వయస్సు గురించి కాదు పరిగణించలేము
he was born at kanyakumari district of tamil nadu	తమిళనాడు కన్యకుమారి జిల్లా నాగర్ కోయిల్లో పుట్టారు
the list includes hindi bengali gujarati kannada telugu tamil and malayalam	బెంగాలీ గుజరాతీ మరాఠీ కన్నడ పంజాబీ మలయాళం తమిళ్ తెలుగు ఆ జాబితాలో ఉన్నాయి
australia scored in the first innings	ఆస్ట్రేలియా తొలి ఇన్నింగ్స్  పరుగులు చేసిన విషయం తెలిసిందే
several animals perished	ఎన్నో జంతువులు చెల్లాచెదురయ్యాయి
keerthy suresh went on to win best actress award for her role in mahanati	ఇక మహానటి సినిమాలో నటనకు గాను కీర్తి సురేష్ ఉత్తమ నటి అవార్డును సొంతం చేసుకున్నారు
why how	ఎందుకు ఏమిటి ఎలా
it is not a rule	రూల్స్ పెట్టేది కాదు
here publication and electronic media is welldeveloped	ఇక్కడ ప్రచురణ మరియు ఎలక్ట్రానిక్ మీడియా బాగా అభివృద్ధి చెందింది
the budget earmarked rs	బడ్జెట్లో కేంద్ర నిధులు రూ
turn around and repeat	దిండు మీద తిరుగుతూ మరియు పునరావృతం చేయండి
mental health is as important as physical health	శారీరక ఆరో గ్యంతో సమానంగా మానసిక ఆరోగ్యం ప్రాధాన్యత సంతరించుకుంది
lakh under section c of the income tax act	లక్షల మొత్తంపై సెక్షన్ సీ కింద పన్ను మినహాయింపు లభిస్తుంది
he would never say such a thing	ఈ విషయం తనకు ఎన్నడూ చెప్పలేదే అని వాపోయింది
each entrance is ft wide and out of the entrances one is reserved only for females	ప్రతి ప్రవేశ ద్వారం  అడుగుల వెడల్పు కలిగి ఉండగా వీటిలో ఒక ప్రవేశ ద్వారం మాత్రం కేవలం స్త్రీల కోసం మాత్రమే
did salman khan give you any advice	సల్మాన్కు ఏమైనా సలహా ఇస్తారా
the apostle peter shed additional light on the connection between reproach and happiness	నిందకు సంతోషానికీ మధ్య ఉన్న సంబంధంపై అపొస్తలుడైన పేతురు మరింత వెలుగును ప్రసరింపజేశాడు
but it could be done	ానీ దాన్ని సాధ్యం చేసి
however the situation is under control	అయితే పరిస్థితి మాత్రం అదుపులోనే ఉందన్నారు
dont talk about other people	ఇతర వ్యక్తుల గురించి ప్రస్తావించకండి
some people dont	కొంతమంది చెప్పరు
the member of board of revenue	బోర్డ్ ఆఫ్ రెవెన్యూ సభ్యుడు
four are critically injured	తీవ్ర గాయాలయిన నలుగురిని
virat kohli and dale steyn	డేల్ స్టెయిన్ విరాట్ కోహ్లీ
polls could be delayed	ఎన్నికల ఫలితాలు వెల్లడి ఆలస్యమయ్యే అవకాశం
the easiest and cheapest way to get to the temple is by bus but auto rickshaws can be hailed to the temple once you are in the city	అయితే మీరు నగరంలోకి వచ్చినప్పుడు ఆటో రిక్షాలు ద్వారా ఆలయానికి చేరుకోవచ్చు
challenge for congress	కాంగ్రెస్ పార్టీకి సవాల్
trs leaders celebrate ktrs birthday	జన్మదిన శుభాకాంక్షలు తెలిపిన టీఆర్ఎస్ వర్కింగ్ ప్రెసిడెంట్ కేటీఆర్
everyones happy	ప్రతి ఒక్కరూ ఆనందంగా ఉన్నారు
their third game against sri lanka was washed out due to rain	తదుపరి శ్రీలంకతో ఆడాల్సిన మూడో మ్యాచ్ వర్షం కారణంగా రద్దయ్యింది
the stories are important	సినిమాకి కథ ముఖ్యం
no one sold them in shops	ఈ వేళ దుకాణాల వాళ్లెవ్వరూ నెయ్యి అమ్మలేదు
a sound is heard by the ears	గొంతులోంచి కూతలాంటి చప్పుడు వస్తోంది
i didnt realise when it began and when it ended	ఎప్పుడు స్టార్ట్ చేశామో ఎప్పుడు ఫినిష్ అయిందో తెలీలేదు
all files	అన్ని ఫైళ్ళు
the government is drafting a policy for the purpose	దీని కోసం ప్రభుత్వం ఒక ప్రణాళిక రూపొందిస్తోంది
he started running	పరుగు ప్రారంభించాడు
during the current tamil month of purataasi a large number of devotees visit the temple	తమిళులు ఎంతో పవిత్రంగా భావించే పెరటాసి మాసంలో పెద్ద సంఖ్యలో భక్తులు విచ్చేసి స్వామివారిని దర్శించుకుంటున్నారు
where is god	దేవతలు ఎక్కడున్నారు
one passenger was killed unintentionally	ఈ దోపిడీలో ప్రమాదవశాత్తూ ఒక ప్రయాణికుడు చనిపోయాడు
kannada actor puneeth rajkumar	ఈ చిత్రాన్ని కన్నడలో నటుడు పునీత్ రాజ్కుమార్ నిర్మించారు
since then	ఆ తరువాత నుండి
million	లక్షలు పలుకుతోంది
mr palkar	మిస్టర్ పాల్కర్
aditi rao hydari nivetha thomas and sudheer babu plays the leads in the movie	ఈ చిత్రంలో నానితో పాటూ నివేదా థామస్ అతిథి రావు హైదరి సుధీర్ బాబు వంటివారు ప్రధాన తారాగణంగా నటిస్తున్నారు
its advantage customers	దీంతో కస్టమర్లకు ఊరట
screen resolution is pixels x pixels	రిసల్యూషన్   పిక్సల్స్
it all started in my home region of northern kyrgyzstan	అదంతా మా స్వస్థలమైన ఉత్తర కిర్గిజ్స్థాన్లో జరిగింది
the complaint was then filed against the owner	అనంతరం సంపు ఉన్న ఇంటి యజమానిపై కేసు నమోదు చేశారు
the legacy has to be carried forward	ఆ వారసత్వాన్ని ముందుకు తీసుకెళ్లాలి
he expressed his heartfelt condolences to jaitleys family members	జైట్లీ కుటుంబసభ్యులకు ఆయన తన ప్రగాఢ సానుభూతి తెలియజేశారు
lakh in the auctions	లక్షల దాకా పందేలు కాస్తారు
dil raju mahesh babu and ramabrahmam sunkara together produced the movie	దిల్రాజు మహేశ్బాబు రామబ్రహ్మం సుంకర సంయుక్తంగా ఈ సినిమాని నిర్మిస్తున్నారు
the question is how	ప్రశ్న ఇతర ఉంది  ఎలా
the list continues to increase	ఇక ఈ వ్యూస్ లిస్ట్ ఇంకాస్త పెరిగిపోతూనే ఉందట
reluctant officials	ఇష్టారాజ్యంగా వ్యవహరిస్తున్న అధికారులు
medium and small scale enterprises	ఎంఎన్సీల బాటలో స్మాల్ మీడియం స్కేల్ కంపెనీలు
gold prices are on an upward trend again	బంగారం ధరలు మరోసారి పెరుగదల బాట పట్టాయి
these are many	ఇలా చాలా ఉంటాయి
god has done it	అనిసమాధాన మిచ్చాడు దేవుడు
published recently	ఇటీవల నోటిఫికేషన్ను విడుదల చేసింది
make no mistake though	అయినా తప్పడం లేదు
the government should pay it	ప్రభుత్వమే చెల్లించాలి
lord remember david and all his afflictions	యెహోవా దావీదునకు కలిగిన బాధలన్నిటిని అతని పక్షమున జ్ఞాపకము చేసికొనుము
running scared	భయంతో పరుగులు
bribery and fraud	మోసాలు అన్యాయాలు
crore	కోట్లు
but do	అయితే ఇలా చెయ్యండి
mobile phones longterm health hazard says study	పరిశోధన దీర్ఘకాల సెల్ ఫోన్ వాడకం ఆరోగ్య ప్రమాదాలను కలిగిస్తుంది అని సూచిస్తుంది
one dies in road accident	రోడ్డు ప్రమాదంలో ఒకరు మృతి
rs crore	కోట్లు
could not move file to the trash	దస్త్రమును చెత్తకుండికి కదల్చలేము
however a lot of people are worried about sharing their aadhaar details	అయితే ఆన్లైన్లో ఆధార్ వివరాలు లీక్ అవుతున్నాయని పలువురు ఆందోళన చెందుతున్నారు
so go for it	కాబట్టి తిమితం గా తీస్కోండి
the state shall endeavour to protect and improve the environment and to safeguard the forests and wild life of the country	ఏ రాజ్యము పరిసరములను కాపాడి అభివృద్ధి చేయుటకును దేశములోని అడవులను వరిసరముల రక్షణ వన్యప్రాణులను సంరక్షించుటకును ప్రయత్నించవలెను
still miss you badly	మీరంతా బాగా అలసి పోయి ఉన్నారు
when not goofing off however he can be surprisingly cautious	కానీ అతడు ఏ నేరం చేయలేదు అతడి చర్యను గరిష్టంగా అవినీతిగానే అభివర్ణించవచ్చు
speaker volume level	శబ్ద స్థాయి
belgium raises terror alert to highest level in brussels	బెల్జియం రాజధాని బ్రసెల్స్ లో హై అలర్ట్ ప్రకటించారు
hyderabad the telangana rashtra samithi trs has announced its nominees for the upcoming rajya sabha elections	హైదరాబాద్ రాజ్యసభ ఎన్నికల్లోనూ తెలంగాణ రాష్ట్ర సమితి టిఆర్ఎస్ తన సత్తా చాటనుంది
abhishek pictures has bought the movie	అభిషేక్ పిక్చర్స్ ఈ సినిమా రీమేక్ హక్కులను సంపాదించింది
price is rs	ఉండగా ధర తగ్గింపు తర్వాత రూ
in october williams released his second greatest hits album in and out of consciousness the greatest hits to celebrate years as a performing artist	జూన్ లో విలియమ్స్ రెండో గ్రేటెస్ట్ హిట్స్ ఆల్బమ్ను విడుదల చేస్తున్నట్లు ప్రకటన వెలువడింది          సంగీత ప్రపంచంలో తన  ఏళ్ల ప్రయాణాన్ని పురస్కరించుకొని దీనిని విడుదల చేయనున్నట్లు వెల్లడించాడు
not bad right	అది చెడు కాదు
total builtup area sq	చదరపు మీటర్ల భూభాగం యొక్క మొత్తం వైశాల్యం
i want to stay here	ఇక్కడే సెటిల్ అవ్వాలనుకుంటున్నాను
in a bid to attack the modi government	ోడీ సర్కారుపై ముప్పేట దాడినే చేస్తున్నాయి
theres the craft see	అలాగే మద్రాసులో చేయగా చూశారు
but we need to remember	అయితే మేము అనుభూతులను గుర్తుపెట్టుకోవాలి
killer of bangladeshi hindu priest killed in shootout	బంగ్లాలో కత్తులతో పొడిచి మరో హిందూ పూజారి హత్య
whys everyone running	అన్నిటా ఉరుకులు పరుగులు పెడుతున్నానెందుకు
form changes	ఫారమ్ మార్పులు
the state financially supports the museum and owns both the collection and the building	ఈ రాష్ట్రం సంగ్రహాలయానికి ఆర్థికంగా మద్దతు ఇస్తుంది ఇది ఇక్కడి సేకరణ భవనం రెండింటినీ కలిగి ఉంది
sounds amazing but true	వినడానికి ఆశ్చర్యంగా ఉన్నప్పటికీ ఇది నిజమే
the nature is beautiful here	ఇక్కడ ప్రకృతి అందాలకు కొదవే లేదు
the protest has started	నిరసన ప్రారంభమయింది
we answer	మేము కడుతున్నాం అని సమాధానం చెబుతున్నారు
among the dead was a woman and a child	మృతుల్లో ఓ చిన్నారి ఓ బాలిక ఉన్నారు
nevertheless the kenite shall be wasted until asshur shall carry thee away captive	అష్షూరు నిన్ను చెరగా పట్టువరకు కయీను నశించునా
virat kohli ranks second on the list	టీమిండియా కెప్టెన్ విరాట్ కోహ్లీ రెండో ర్యాంకులో కొనసాగుతున్నాడు
ram absolutely	రామారావ్ అబ్బా
internal storage gb	ఇంటర్నల్ స్టోరేజ్ జీబీ
likewise the inch dec rx floppy held bytes formatted and was advertised as k	అదే విధంగా  అంగుళాల   ఫ్లాపీ  ఫార్మాట్ చేయబడిన  బైట్ల పరిమాణంతో తయారుచేసి ప్రకటనలలో  అని తెలియజేసారు
the wife was dismayed	భార్య అనాకారి అయింది
he drew his attention towards problems of the farmers	రైతు సమస్యలపై ప్రత్యేక దృష్టి పెట్టాం
it is merely a trickle	ఇక జస్ట్ తాళిబొట్టు కట్టడమే
the same way	అదేవిధంగా
age to years	నుంచి  ఏళ్లలోపున్న యువతీయువకులు అర్హులు
locally connected printer	స్థానికంగా అనుసంధానించబడివున్న ముద్రకము
pawan kalyan and chiranjeevi	చిరంజీవితో కలిసి దీపావళి సంబరాలను జరుపుకున్న పవన్ కళ్యాణ్
its temperature fluctuates depending on the season	ఋతువులను బట్టి శీతోష్ణస్థితిని బట్టీ ఇది మారుతూంటుంది
kareena kapoor khan and saif ali khan are chilling in cape town south africa on the occasion of son taimur ali khans second birthday	బాలీవుడ్ సూపర్ స్టార్స్ సైఫ్ ఆలీఖాన్ కరీనా కపూర్ ముద్దుల కుమారుడు తైమూర్ రెండవ పుట్టిన రోజును సౌత్ ఆఫ్రికాలోని కేప్టౌన్లో జరిపారు
jamal khan jimmi	జమల్ ఖాన్  జిమ్మీ
the quiz was held in total eight rounds	ఆడిషన్స్ మొత్తం సిక్స్ రౌండ్స్ జరిగాయి
the climax is intriguing	క్లయిమాక్స్ ఉత్కంఠగా వుంటుందన్నారు
rahul ravindran directed nagarjuna akkineni and rakul preet singh in the new movie manmadhudu	కింగ్ నాగార్జున మరియు బ్యూటీ హీరోయిన్ రకుల్ ప్రీత్ సింగ్ లు హీరో హీరోయిన్లు రాహుల్ రవీంద్రన్ దర్శకత్వంలో తెరకెక్కిన తాజా రొమాంటిక్ ఎంటర్టైనర్ చిత్రం మన్మథుడు
bumrahs best bowling figures are	బుమ్రా అత్యుత్తమ బౌలింగ్ ఫిగర్స్
to learn more	మరింత తెలుసుకోవడానికి
but is it crazy	కానీ ఇంత పిచ్చా అనుకుంటున్నారా
killed in	మంది దుర్మరణం
the strike by the rtc employees is illegal he argued	ఆర్టీసిలో సమ్మె చట్టవిరుద్ధమని ఆయన చెప్పారు
jadhav a former indian navy officer was sentenced to death by a pakistani military court in april on charges of spying and terrorism	గూఢచర్యం ఆరోపణలతో భారత నేవీ మాజీ అధికారి కుల్భూషణ్ జాదవ్కు పాక్ సైనిక కోర్టు ఏప్రిల్ నెలలో మరణశిక్షను విధించిన విషయం తెలిసిందే
lakh and rs	లక్షల వరకు పెంచాలని అలాగే హెచ్ఆర్ఏ ను రూ
insurance cover	బీమా హామీ
a gentle and cool breeze blows on the beach throughout the day making it an ideal spot for a picnic	నల్లటి ఇసుకతిన్నేలతో కావలసినంత నీడతో ఉండే ఈ తీరం సకుటుంబంగా విహారాలకు వెళ్ళడానికి బాగుంటుంది
the incident took place in adoni of kurnool district	కర్నూలు జిల్లా ఆదోని మండలం దొడ్డనాకేరి గ్రామంలో ఘోరం చోటుచేసుకుంది
i was surprised	అని ఆశ్చర్యపడ్డాను
we should note the two expressions the works of the flesh and the fruitage of the spirit	ఒక చెట్టును జాగ్రత్తగా పెంచినప్పుడు అది ఫలాలను ఉత్పన్నం చేసినట్లే ఒక వ్యక్తి జీవితంలో పరిశుద్ధాత్మ ధారాళంగా ప్రవహించినప్పుడు ఆయన ఆత్మ ఫలాలను ప్రదర్శిస్తాడు   కీర్తన
lakh crore	కోట్ల వరకు తీసుకునేదట
waning movement	తగ్గిన కదలిక
it was hard at first	మొదట్లో చాలా కష్టం అనిపించింది
perfectly normal	సంపూర్ణ సాధారణ
i want to sleep	నిద్ర లేపి ఇవ్వాలనుకుంది
situation went out of control	పరిస్థితి అదుపు తప్పింది
where are the crores of people	క్ష కోట్లు ఎక్కడ
thousand	వేలు దిగమింగుతున్నారు
medical breakthrough	వైద్యవిద్యకు గ్రహణం
a woman is driving down the same road	ఆ మార్గంలోనే ఓ మహిళ కూడా కాలినడకన వెళ్తుంది
i do not ask for justice	నాకు న్యాయం జరుగడం లేదు
she was immediately shifted to a nearby hospital	జడేజా వెంటనే ఆమెను దగ్గరలోని ఆసుపత్రికి తీసుకెళ్లినట్టు సమాచారం
mission mangal is about the mars orbiter mission by the indian space research organisation isro	ఇస్రో చేపట్టిన మార్స్ మిషన్ ప్రాజెక్టు కథాంశంతో వచ్చిన చిత్రం మిషన్ మంగళ్
nitish kumar is an indian politician	నితీష్ కుమార్కు సీజనల్ పొలిటీషియన్గా పేరుంది
denis anyone	ఏ లెన్స్
hyderabad on learning about his wifes extramarital affair a man committed suicide	హైదరాబాద్ మైలార్దేవ్పల్లి పీఎస్ పరిధిలో దారుణ హత్య
leaning to skateboard in a warzone if youre a girl on the other hand won the oscar for documentary short subject	ఈ నేపథ్యంలో తీసిన లెర్నింగ్ టు స్కేట్బోర్డ్ ఇన్ ఏ వార్ జోన్ ఇఫ్ యు ఆర్ ఏ గర్ల్ డాక్యుమెంటరీ షార్ట్ సబ్జెక్ట్ విభాగంలో ఆస్కార్ అవార్డు గెలుచుకుంది
pacemaker a small device thats placed under the skin helps to control arrhythmias	గుండె జఠరికను నియంత్రించడానికి సహాయంగా చర్మం కింద అమర్చిన ఒక చిన్న ఎలక్ట్రానిక్ పరికరం పేస్ మేకర్
the madras high court had upheld the lower court order	ఈ మేరకు మద్రాస్ హైకోర్టు ఇచ్చిన శిక్షను దేశ సర్వోన్నత న్యాయస్థానం సమర్థించింది
health of children should be looked after	పిల్లల ఆరోగ్యంపట్ల కూడా ప్రత్యేక శ్రధ్ద వహించాలి
under the national health protection scheme we are providing health care coverage of us dollars per family per year effectively covering over million indians	జాతీయ ఆరోగ్య పరిరక్షణ పథకం కింద మేము సంవత్సరానికి కుటుంబానికి  అమెరికా డాలర్ల మేర డాలర్ల ఆరోగ్య సంరక్షణ సౌకర్యాన్ని అందిస్తున్నాము
he taught english	ఆంగ్లం నేర్చుకున్నారు
of around rs	అందులో భాగంగా సుమారు రూ
everyday activities	రోజువారీ పనులు
directed by vamshi paidipally maharshi stars mahesh babu and pooja hegde	మహేష్ సరసన పూజ హెగ్డే హీరోయిన్ గా నటించిన ఈ సినిమాకు వంశీ పైడిపల్లి దర్శకత్వం వహించారు
i loved being in their company and admired their hardworking spirit	నేను అప్పటికి ఇంకా బాప్తిస్మం కూడా తీసుకోలేదు సాక్ష్యమివ్వడంలో అనుభవమూ అంతంతే
in delhi petrol price per litre is priced at rs	జనవరిలో లీటర్ పెట్రోల్ ధర ఢిల్లీలో రూ
cricket is such a funny game	క్రికెట్టంటే మెన్గేమ్ అన్నట్టుంటుంది
unable to sleep at night	రాత్రిపూట సరిగా నిద్రపట్టడం లేదు
cold is quite common in winters	శీతాకాలంలో జలుబు రావడం సర్వ సాధారణం
resist the spirit of a changing world	మారుతున్న లోక స్వభావాన్ని ఎదిరించండి
kcr asked	అని కెసిఆర్ దేవరకద్ర సభలో ప్రశ్నించారు
its timing was changed in the morning when atal bihari vajpayee government came into power and budget was presented just after the commencement of the parliament session	అటల్ బిహారీ వాజ్ పేయి ప్రభుత్వం అధికారంలోకి వచ్చిన తరువాత బడ్జెట్ ను సమర్పించే సమయాన్ని ఉదయం పూటకు మార్చడమైంది బడ్జెటును పార్లమెంట్ సమావేశాలు మొదలైన వెంటనే సమర్పించారు
to think	ఆలోచించాలి
allahabad high court	అలహాబాద్ హైకోర్టు ప్రాంగణంలో ఘటన
election commissions order	ఉత్తర్వులు వెలువరించిన ఎన్నికల కమిషన్
all four men raped her	ఆ నలుగురూ కలసి ఆమెను క్రురంగా అత్యాచారం చేశారు
when i do bad i feel bad	నేను చెడ్డగా ఉన్నప్పుడు నేను చెడుగా భావిస్తున్నాను
lets get married	పెళ్లి చేసుకుంటానని పిలిపించి
data is the	డేటానే  కీలకం
she was so scared	ఆమె చాలా భయపడింది
how did it grids get hold of government data	ఐటీ గ్రిడ్స్ సంస్థకు ప్రభుత్వ డేటా ఎలా వచ్చింది  టీడీపీ సేవా మిత్ర యాప్కు ప్రజల రహస్య సమాచారం ఎలా వచ్చింది
the commanding officer would receive a gold medal and his officers silver medals	దాని ప్రకారం కమాండింగ్ అధికారికి బంగారు పతకం అతని అధికారులు వెండి పతకాలు అందుకుంటారు
both of them decided to get married	వీరిద్దరూ పెళ్లి కూడ చేసుకోవాలని భావించారు
by asking questions	అనే ప్రశ్నలతో ముంచెత్తుతున్నారట
list of icon sizes gtkmenugtkbutton	ప్రతిమ పరిమాణముల జాబితా
all of them are rs	ఇవన్నీ కూడా రూ
virtual desktop three is selected	వర్చ్యువల్ డెస్క్ టాప్ మూడవది ఎంపికైంది
dont fear anybody	ఎవ్వరికీ భయపడరు
show the previous page	గతంలోని పుటను చూపు
greyblack	నీలిమ అంటే నలుపు
development nationalism national security are the issues which are core to bjp	ప్రధానంగా జాతీయవాదం జాతీయ భద్రత అభివృద్ధి అనే మూడు అంశాలే ఇందుకు కారణం
cultivation and cattle farming are the main occupations of the inhabitants	ఈ గ్రామంలో ప్రధాన వృత్తులు వ్యవసాయము వ్వవసాయాథారిత మైన పనులు
thousand	వేలు వస్తాయి
but money no	కాని డబ్బులు రావు
the us celebrates diwali	అమెరికాలో ఘనంగా దీపావళి సంబరాలు
its still rising	ఇంకా ఇంకా పెరుగుతోంది
constant efforts are needed for victory	ఆ గెలుపుని నిలబెట్టుకోవాలంటే నిరంతరం శ్రమించాలి
why is mixer shutting down	ఎందుకు రేడియేటర్ మూసుకుపోతుంది
thats okay though	ఆవిడ అయితే బాగుంటుంది
the movie is based on a love story	ఈ చిత్రాన్ని ఓ వెరైటీ ప్రేమకథ నేపథ్యంలో తెరకెక్కిస్తున్నారు
women are best administrators	ఉత్తమ మేనేజర్లు మహిళలే
for more details check their websites	మరింత సమాచారం కొరకు కొన్ని వెబ్ సైట్ లు చూడండి
the centre recently abrogated article which gave special status to jammu and kashmir	జమ్మూ కశ్మీర్కు స్వయం ప్రతిపత్తి కల్పించే వ అధికరణాన్ని ఇటీవల కేంద్రం రద్దు చేసిన సంగతి విదితమే
bangladeshs shakib al hasan maintained his top spot in the allrounder rankings	ఆల్రౌండర్ విభాగంలో బంగ్లాదేశ్కు చెందిన సాకిబ్ అల్ హసన్ టాప్ ర్యాంక్ను సాధించాడు
mla offers help to family	బాధిత కుటుంబానికి ఎమ్మెల్యే సాయం
financial crisis	కమ్ముకొస్తున్న ఆర్థిక మాంద్యం
plastic bag	ప్లాస్టిక్ సంచి
no one else was in the car	కారులో మరెవ్వరూ వ్యక్తులున్నట్లు కనిపించలేదు
lions club organises free eye check up camp	లయన్స్ క్లబ్ ఆధ్వర్యంలో ఉచిత నేత్ర వైద్య శిబిరం
maharashtra gujarat tamil nadu madhya pradesh and delhi are having more number of cases	ఢిల్లీ తమిళనాడు మధ్యప్రదేశ్ కేరళ గుజరాత్లో కూడా కరోనా కేసులు మరణాలు ఎక్కువగా నమోదవుతున్నయి
he won indias first athletics gold medal in indonesia	దీంతో ఇండియాకు అథ్లెటిక్స్లో తొలి స్వర్ణం అందించాడు
food diet is a must for healthy and better living	ఆహారాలు మనుగడ మరియు ఆరోగ్యకరమైన జీవనంకు ఉపయోగపడేవి
the answer to these questions is yes	ఈ ప్రశ్నలకు అవుననే సమాధానం వస్తుంది
ill be watching you	నేను చూసుకుంటానుగా
more discounts	మరిన్ని సడలింపులు
the nearest railway station is ramagundam	గ్రామానికి దగ్గర్లోని రైలు స్టేషను రాజమహేంద్రవరం
oil pipeline leakage	ఆయిల్ పైప్లైన్ లీక్ నిప్పంటించిన దుండగులు
yes its not easy	అవును సమస్య సులభం కాదు నిజంగా ఉంది
i am open to doing films again	మళ్లీ సినిమా పనుల్లో నిమగ్నమయ్యేందుకు సిద్ధంగా ఉన్నాను
atal bihari vajpayee was born on december in gwalior to krishna devi and krishna bihari vajpayee	అదే రోజు అంటే  డిసెంబర్ న కారణజన్ముడు అటల్ బిహారీ వాజ్పేయి జన్మించారు
the yearold	అడవిదొంగకి  ఏళ్లు
movie has family comedy and love based story	కామెడీ లవ్ మిస్టరీ అంశాలతో ఉత్కంఠభరితంగా సాగే చిత్రమిది
we can go anywhere	ఎక్కడికి పడితే అక్కడికి రాగలం
heres how to use it	అది ఉపయోగించి కోసం పద్ధతి ఈ విధంగా ఉంటుంది
she gave birth to a son	ఆమె పండంటి మగ బిడ్డకు జన్మనిచ్చారు
please tell in detail	వివరంగా తెలియచేయగలరు
bjp has seats while shiv sena has	బీజేపీకి  సీట్లు వస్తే శివసేనకు  సీట్లు వచ్చాయి
cinema regulation acts	సినిమా నియంత్రణ చట్టాలు
the video clip had created a huge controversy	ఈ వీడియో ఫుటేజీ బయటకొచ్చి తీవ్ర చర్చకు దారి తీసింది
salman khurshid revolts against rahul gandhi	రాహుల్ గాంధీపై సల్మాన్ ఖుర్షీద్ సంచలన వ్యాఖ్యలు
fish like mackerel herring tuna and salmon are rich in omega fatty acids	సాల్మన్ ట్యూనా హలిబుట్ వంటి చేపలలో మరియు ఇతర సముద్ర ఆహారాలు అయిన ఆల్గే మరియు క్రిల్ వంటి వాటిలో ఒమేగా  కొవ్వు ఆమ్లాలు సమృద్దిగా లభిస్తాయి
everyone is being closely monitored	అందరూ చాలా జాగ్రత్తగా చూసుకుంటారు
it changed	దారి మార్చేసింది
weve learned three big lessons about relationships	పిరియడ్ మనం సంబంధాల గురించి మూడు పెద్ద పాఠాలు నేర్చుకున్నాము
nature freak	ప్రకృతి మాత
we shall elaborate on it in future	ఇది మేము భవిష్యత్తులో మరింత పరిశీలించబోతున్నది
why women shy off	ఆడవాళ్ళకే కన్నీళ్లు ఎందుకు వస్తాయి
after the postmortem at wenlock hospital in mangaluru the body was taken to chikkamagaluru	కాగా మంగళూరులోని వెన్లాక్ ఆస్పత్రిలో పోస్టుమార్టం అనంతరం మృతదేహాన్ని అంత్యక్రియల కోసం సిద్ధార్థ స్వస్థలమైన చిక్కమగళూరుకు తీసుకు వచ్చారు
the remaining part of the area is known as lower alanknanda valley	మిగిలిన మైదానాన్ని దిగువ అలకనందా మైదానం అంటారు
if proven guilty accused can face a death or life sentence	నిందితులు దోషులుగా తేలితే యావజ్జీవం గానీ ఉరి శిక్ష గానీ విధించే అవకాశం ఉంది
sindhu had reached her maiden super series final at the denmark open last year but the title eluded her then as she lost in straight games to olympic champion chinas li xuerei	కాగా గత ఏడాది డెన్మార్క్ ఓపెన్ సిరీస్ ఫైనల్కు చేరిన సింధు చైనా క్రీడాకారిణి లీ జ్యుర్ చేతిలో ఓటమి పాలైంది
physical exercise is very important	వ్యాయామం చాలా కీలకం
each such kit consisting of items is meant to assist one needy family for some time	తొమ్మిది వస్తువులతో కూడిన ఈ కిట్ ఒక నిరుపేద కుటుంబానికి కొన్ని రోజుల అవసరాన్ని తీరుస్తుంది
the modi government has ordered a cbi probe into the case	సీబీఐ దర్యాప్తుకు ఆదేశించినది మోడీ ప్రభుత్వం కాదన్న విషయం తెలుసుకోవాలన్నారు
megapixel front camera	మెగా పికల్స్ ప్రైమరీ కెమెరా
the sr is priced at rs exshowroom panindia	లు ఎక్స్షోరూమ్ఇండియాగా ఉంది
he has to take a final decision	ఫైనల్ గా ఆయన ఏ నిర్ణయం తీసుకుంటాడో చూడాలి
he succeeded sushil chandra who was appointed as an election commissioner	కేంద్ర ఎన్నికల సంఘం కమిషనర్ గా సుశీల్ చంద్ర నియమితులయ్యారు
hyderabad second phase of polling in the panchayat elections in telangana got over peacefully	హైదరాబాద్ గ్రామ పంచాయతీ మొదటి విడత ఎన్నికలు ప్రశాంతంగా ముగిశాయి
us president donald trump blamed the attack on iran	ఇరాన్ వల్లే ఈ దాడి జరిగిందని అమెరికా అధ్యక్షుడు డొనాల్డ్ ట్రంప్ ఆరోపించారు
directed by anil ravipudi the romantic action drama features mahesh babu in the role of an army officer	అనిల్ రావిపూడి డైరెక్షన్లో తెరకెక్కిన సరిలేరు నీకెవ్వరు సినిమాలో మహేష్ ఆర్మీ ఆఫీసర్ పాత్రలో నటిస్తుండగా రష్మిక మందన హీరోయిన్గా నటించింది
it is pretty common disease in children	ఇది పిల్లల్లో అత్యంత తరచుగా సంభవించే అరుదైన వ్యాధి
shankar was run out off the penultimate ball	ఐదో బంతికి శంకర్ ఔటయ్యాడు
know the truth	అసలు నిజం తెలుసుకుని
their desires fulfilled	తమ వాంఛను తీర్చుకొని మట్టుబెట్టారు
andhra pradesh karnataka and tamil nadu has large nandi temples	ఇంకా కర్ణాటక తమిళనాడు ఆంధ్రప్రదేశ్ లలో కూడా కొన్ని దేవాలయాలున్నాయి
jesus did not abuse the authority entrusted to him by controlling peoples lives he neither set unreachable standards nor laid down countless rules	ప్రజల జీవితాలను అదుపుచేస్తూ యేసు తనకివ్వబడిన అధికారాన్ని దుర్వినియోగం చేయలేదు
circumstances may frustrate even the noblest of plans ecclesiastes	ఎంత ఉదాత్త పథకాలైనా పరిస్థితులు ఆశాభంగం కలిగించవచ్చు   ప్రసంగి
whats the sting	ఏమిటా చలువరాతికొండ
today however current production is at the rate of passenger cars and ten trucks and buses per minute every working day	అభివృద్ధి చెందుతున్న దేశాలు  కోట్ల  లక్షలమంది పిల్లల విషయంలో ఒక విద్యా సంక్షోభాన్ని ఎదుర్కొంటున్నాయి
she was then	ఆ సమయంలో ఆమెకు  ఏళ్లు
it received three awards	ముగ్గురు ప్రముఖులకు ఈ అవార్డులు దక్కాయి
but though	అయితే ఇప్
new delhi may president ram nath kovind on saturday dissolved the th lok sabha as part of a formality before the constitution of the new parliament	న్యూఢిల్లీ  వ లోక్ సభను రాష్ట్రపతి రామ్ నాథ్ కోవింద్ రద్దుచేశారు
singapore hong kong and paris share the ranking for the most expensive place in the world	నివసించేందుకు ప్రపంచంలో అత్యంత ఖరీదైన నగరాలుగా పారిస్ సింగపూర్ హాంకాంగ్ నగరాలు నిలిచాయి
the secret survey	రహస్య విచారణ
in case potable water piped connections cannot be ensured before december as an interim measure potable water lpcd for drinking and cooking purpose is to be provided by installing community water purification plants cwpp	ఒకవేళ  డిసెంబరు లోగా త్రాగునీటి పైపు కనెక్షన్లను ఏర్పాటు చేయని పక్షంలో మధ్యంతర చర్యగా త్రాగడానికి వంట చేసుకోడానికి  ఎల్ పి సి డి చొప్పున సామాజిక నీటి శుద్ధి ప్లాంట్లు సి
pratapraju has released the movie in telugu	తిరుపతి ప్రసాద్గారు తెలుగులో సినిమాను విడుదల చేస్తున్నారు
but to everyones surprise	కానీ అందరికీ షాక్
autocomplete code	కోడ్ స్వయంసమాప్తి
in fact the rs	నిజానికి ఆర్థిక శాఖ రైతు భరోసాకు రూ
initially rs	ఎన్ఎస్ఈలో తొలుత రూ
thats its specialty	అదే ఆమె ప్రత్యేకత
chop celery into tiny pieces	వెల్లుల్లి సన్నని ముక్కలు లోకి కట్
rent controller	అద్దె నియంత్రిక
ajinkya rahane krishnappa gowtham sanju samson shreyas gopal aryaman birla sudhesan midhun prashant chopra stuart binny rahul tripathi dhawal kulkarni mahipal lomror jos buttler ben stokes steve smith jofra archer ish sodhi jaydev unadkat varun aaron oshane thomas shashank singh liam livingstone shubham ranjane manan vohra ashton turner riyan parag	రాహుల్ త్రిపాఠి అజింక్య రహానె సంజు శాంసన్ హెన్రిచ్ క్లాసెన్ స్టువర్ట్ బిన్నీ గౌతమ్ జోప్రా ఆర్చర్ శ్రేయాస్ గోపాల్ ఇస్ సోధి జయదేవ్ ఉనద్కత్ బెన్ లాలిన్
indias economy is expected to grow five fold by	నాటికి భారతదేశ ఆర్థిక వ్యవస్థ ఐదు రెట్లు పెరుగుతుందని అంచనా
take a proper diet to remain healthy	సరైన ఆహారం తీసుకోవాలి ఫిట్నెస్ కాపాడుకోవాలి
one young bullock one ram one lamb of the first year for a burnt offering	ఏడాది గొఱ్ఱపిల్లను పాపపరిహారార్థ బలిగా ఒక మేకపిల్లను
lodging and food	నివాస మరియు ఆహార సమాచారం
for ac first classexecutive class rs	ఎసి ఫస్ట్ క్లాస్  ఎగ్జిక్యూటివ్ క్లాస్కు రూ
theyve different traits	వారు వివిధ భావాలు ఉంటాయి
he is up against bjps kummanam rajasekaran and ldfs c divakaran	ఈ ఎన్నికల్లో భాజపా అభ్యర్థి కుమ్మనం రాజశేఖరన్ సీపీఎం నేతృత్వంలోని ఎల్డీఎఫ్ అభ్యర్థి దివకరణ్తో ఆయన పోటీపడనున్నారు
the movie is directed by puri jagannadh and produced by v ananda prasad under bhavya creations	బాలకృష్ణ హీరోగా పూరి జగన్నాథ్ దర్శకత్వంలో భవ్య క్రియేషన్స్ పతాకంపై వి ఆనందప్రసాద్ నిర్మించిన సినిమా పైసా వసూల్
nehru did not approve	నెహ్రూ వారించినా అంగీకరించలేదు
the movie stands at total of rs	ఈ ఫిల్మ్ ఫుల్ థియేట్రికల్ రన్లో వరల్డ్వైడ్గా రూ
how did the people respond chronicles	దానికి ప్రజలెలా స్పందించారు    దినవృత్తాంతములు
people are in splits	ప్రజలు గ్రూపులుగా విడిపోతారు
international and domestic	మరియు విదేశీ మరియు దేశీయ
max j	జెస్సికా
be still	నిశ్చింతగా వుండండి
it was the darkest period of my life	నా లైఫ్ లో చీకటి దశ ఒకటుంది
avoid milk products	పాల ఉత్పత్తులను మానుకోండి
a dual love story	ద్దరి మధ్యా లవ్ స్టోరీ
coronas positive cases are increasing	కరోనా పాజిటివ్ కేసులు నిత్యం అంతకంతకూ పెరుగుతూనే ఉన్నాయి
but who plays	అయితే ఇందులో నటీనటులు ఎవరు
architectural firm skidmore owings and merrill designed the building led by adrian smith	ఈ భవనాన్ని స్కిడ్మోర్ ఆర్కిటెక్చర్ సంస్థ ఓవింగ్స్ మెర్రిల్ ఆండ్రియన్ స్మిత్ నాయకత్వంలోని రూపొందించింది
where do you store them	వాటిని ఎక్కడ స్టోర్ చేశారు
the incident occurred at dhanbad town in jharkhand state	జార్ఖండ్ రాష్ట్రంలోని పిడారీ గ్రామంలో ఈ సంఘటన జరిగింది
present on the occasion was actress rakul preet singh too	వారితో సినీ నటి రకుల్ ప్రీత్ సింగ్ కూడా జత చేరారు ఆమె
as witnesses of jehovah how might we imitate him in speaking and living the truth why is it important to do so	మాటలో సత్యం ప్రకారం జీవించడంలో యెహోవాసాక్షులుగా మనమెలా ఆయనను ఎలా అనుకరించవచ్చు
each floor has four twobedroom apartments	రెండు అంతస్తుల్లోని భవనంలో నాలుగు వార్డులు అందుబాటులో ఉన్నాయి
males are usually more affected by lung cancer than females	పురుషులు మహిళల్లో కంటే ఎక్కువగా ఊపిరితిత్తుల క్యాన్సర్ తో బాధపడుతారు
greater hyderabad municipal corporation mayor mohammad majid hussain is all set to quit his mayor post in a day or two	హైదరాబాద్ మేయర్ మాజిద్ హుస్సేన్ రాజీనామా
the answers to your queries are	మీరడిగిన ప్రశ్నలకు వివృతి
the congress had asked for a reelection	మరోసారి లెక్కించాల్సిందిగా కాంగ్రెస్ కోరింది
the temple is on top of a small hillock	త్రిపురాంతకంలో ఈ ఆలయం ఒక చిన్న కొండ పై ఉంది
according to tarikhiazmi jammu came into existence around ce	తారిఖ్ఇఅజ్మీ గ్రంధాల ప్రకారం సా శ లో జమ్మూ నగరం ఉనికిలోకి వచ్చినట్లు తెలుస్తుంది
kosaraju raghavaiah chowdary paper praja mithra used to write political setairs	కొసరాజు రాఘవయ్య చౌదరి ప్రజామిత్ర పత్రికలో రాజకీయ వ్యంగ్య కవితలు రాసేవారు
ex army chief	మాజీ సైన్యాధిపతి
use of drugs	ది ఉపయోగం మందులు
he talked about theurgent need of capacity building of healthcare workers and augmentation of healthcare infrastructure	అంతేకాకుండా వాటి ని తుచ తప్పకుండా అమలు చేసేటట్టు పర్యవేక్షిస్తుందని పేర్కొన్నారు
why the riots are still continuing in the state	రాష్ట్రంలో గూండారాజ్యం ఎందుకు కొనసాగుతోంది
show cogl options	ఇచ్ఛికాలను చూపుము
it need not be large	దీని విస్తీర్ణం పెద్ద ఉండకూడదు
it is located between guntur and vijayawada	ఇది గుంటూరు విజయవాడ మధ్య ఉంది
her eyes lit up at the mention of his name	ఆ పేరు వినగానే తన కళ్లు మెరిశాయి
i had two stories	రెండు కథలు రాశాను
experienced midfielder namita toppo makes a comeback after a lengthy injury layoff	గాయం కారణంగా ఆటకు దూరమైన మిడ్ఫీల్డర్ నమిత టొప్పొ పునరాగమనం చేసింది
ipl match rr vs dc preview rajasthan look for edge over delhi in lucky venue sharjah	రఫ్ఫాడించిన రాజస్థాన్ ఢిల్లీ తడ బ్యాటు
whats their normal	సాధారణ వారు ఏమి ఉన్నాయి
smoking and drug addiction	మద్యపానం మరియు మాదక ద్రవ్య వ్యసనం
it pains him	అది తనను బాధపెడుతుంది
steve smith has scored another halfcentury	స్టీవ్ స్మిత్ మరొకసారి శతకం సాధించాడు
the number of vehicles on the roads is on the increase	రోడ్లపై జనసంచారం క్రమంగా పెరుగుతోంది
she has acted in tamil telugu and hindi films	తమిళం హిందీ మలయాళ భాషల్లో తన నటనప్రతిభతో రాణించింది
total cases reach	దీంతో మొత్తం కేసుల సంఖ్య కు చేరింది
rs lakh crore	వేల కోట్లు ఖర్చు కావటం గ్యారెంటీనా
director s s rajamouli	దర్శకధీరుడు ఎస్ ఎస్ రాజమౌళి
people queue up outside a polling station in doda under udhampur parliamentary constituency	ఉధంపూర్ పార్లమెంటు నియోజకవర్గంలోని దోడ పోలింగ్ కేంద్రం ముందు సాయుధ పహరా నీడలో ప్రజలు ఓటేసేందుకు పెద్ద ఎత్తున తరలివచ్చారు
mix all the ingredients until well combined	ఈ రెండు పదార్థాలు బాగా కలగలిసే వరకూ బాగా మిక్స్ చేయాలి
he woke up	అతను పొద్దెక్కి లేచేవాడు
he has no airs	అతను గాలి ఉండదు
its a newage love story	కొత్తదనం మేళవించిన ప్రేమకథా చిత్రమిది
young hopes belied	యువతరం ఆశలు ఆవిరి
click on the change password button	పాస్వర్డ్ మార్చండి ప్రాంప్ట్ క్లిక్ చేయండి
he was hospitalised following the deterioration of his health last month	అయితే గత నెలలో వారి ఆరోగ్యం కుదుటపడటంతో ఆసుపత్రి నుంచి డిశ్చార్జి అయ్యారు
a family of writers	ప్రముఖ రచయిత యొక్క కుటుంబం
the bsp has won two seats	బీఎస్పీ మాత్రం ఆగ్నేయ యూపీలోనే కొన్ని సీట్లు పొందగలిగింది
of various colours	అత్యంత విభిన్నమైన రంగులు
is it good taste	రుచి బావుందా
left parties and student groups staged a protest in visakhapatnam	విశాఖలోని మద్దిలపాలెం జంక్షన్లో వామపక్షాలు విద్యార్థి సంఘాలు నిరసనకు దిగాయి
take every single chance	వచ్చిన ప్రతి అవకాశాన్ని సద్వినియోగం చేసుకున్నా
whats the time	ఏయే టైంకు ఏమేం పెడతారు
raina and priyankas friendship dates back to their childhood days	ప్రియాంక రైనాలు చిన్నప్పటి నుండి స్నేహితులు
the movie is reportedly based on the biggest it scam in the world	ప్రపంచంలో అతి పెద్దదైన ఐటీ స్కామ్ నేపథ్య ంలో ఈ సినిమాను తీస్తున్నారు
the model is good	మోడల్ ఏ పనులు బాగుంది
five industriescoal crude oil natural gas cement and electricityrecorded negative growth	బొగ్గు సహజ వాయువు రిఫైనరీ ఉత్పత్తులు స్టీల్ సిమెంట్ విద్యుత్ రంగాలు రెండంకెల ప్రతికూల వృద్ధిని నమోదు చేసుకున్నాయి
she was then	ఆమె అప్పుడు  సంవత్సరాలు
by d raja	డి రాజా
but i dont knowhow	కానీ ఎలా అనేదే తెలియదు
and again	ఇక మళ్ళీ
clue number	కిలాడి నంబర్
i am me	ేను ఉన్నాను
part	పార్ట్
the incident took place last night in the ernakulam district of kerala	కేరళలోని ఎర్నాకులం ప్రాంతంలో ఈ ఘటన చోటు చేసుకుంది
is being charged	ల వరకూ తీసుకుంటున్నారు
want to know how she does it	ఇది ఎలా జరుగుతుందో తెలుసుకోవాలనుకుంటున్నారా
the culprits must be punished	నేరస్తులను తప్పనిసరిగా శిక్షించాలి
thanks for the info	సమాచారం కోసం ధన్యవాదాలు ఇవ్వాలని నిర్ధారించుకోండి
he allegedly has rs crore loan in banks	లక్షలు కార్పొరేషన్ బ్యాంకు నుంచి రుణం తీసుకున్నారు
madhu runs a beauty parlor	మధు వేణు ఒక బ్యూటీపార్లర్ నడుపుతుంటాడు
the cost of rs	పూర్తయ్యేనాటికి వ్యయం రూ
but the result remains the same	కానీ ఫలితం కేవలం అద్భుతమైన ఉంటుంది
but jagan did not speak out against narendra modi	కానీ మోదీకి వ్యతిరేకంగా జగన్ ఒక్క మాట కూడా మాట్లాడరు
nehru yuva kendra sangathannyks national youth corps nyc national programme for youth adolescent development npyad international cooperation youth hostels yh assistance to scouting guiding organizations national discipline scheme nds and national young leaders programme nylp	నెహ్రూ యువ కేంద్ర సంఘటన్ ఎన్ వైకెఎస్ నేశనల్ యూత్ కోర్ ఎన్ వైసి నేశనల్ ప్రోగ్రామ్ ఫర్ యూత్ అడాలసెంట్ డివెలప్ మెంట్ ఎన్ పివైఎడి ఇంటర్ నేశనల్ కోఆపరేశన్ యూత్ హాస్టల్స్ వైహెచ్ స్కౌటింగ్ గైడింగ్ సంస్థలకు సహాయం నేశనల్ డిసిప్లిన్ స్కీమ్ ఎన్ డిఎస్ ఇంకా నేశనల్ యంగ్ లీడర్స్ ప్రోగ్రామ్ ఎన్ వైఎల్ పి
all accused in dadri lynching case arrested	దాద్రి ఘటనలో నిందితులందరి అరెస్ట్
calcium is crucial for bone health and teeth	ఎముకలు మరియు దంతాల పెరుగుదలకు కాల్షియం ఉపయోగపడుతుంది
where and how was it generated	ఎక్కడ మరియు ఎలా అది వచ్చింది
pak rejects indias offer	భారత్ ఆఫర్ ను తిరష్కరించిన పాక్ ప్రధాని
oneman show cuts both ways narendra modi is experiencing it	వన్ మెన్ షో నరేంద్ర మోడీపై వీహెచ్ ఫైర్ కెసిఆర్పై పొన్నాల
zozibini tunzi was crowned by last years winner miss universe catriona gray	విశ్వసుందరి అయిన కాట్రియోనా గ్రే టుంజీ కి కిరీటాన్ని అలంకరించి అభినందించారు
how do the following scriptures help us to discern the timing of the first resurrection	మొదటి పునరుత్థాన సమయాన్ని గ్రహించేందుకు ఈ క్రింది లేఖనాలు ఎలా సహాయం చేస్తాయి
show unmanaged windows on	నిర్వహించని విండోలను దీనిపైన చూపుము
oncospheres can survive in the environment for up to two months	మాంగోస్టీన్ పండు నుండి తీసిన విత్తనాలు బయట వాతావరణంలో  రోజులకంటే ఎక్కువ కాలం జీవించవు
dont leave me	అయినా నన్ను విడిచి నువ్వు ఉండనేలేదు
the results are the same	వే ఫలితాలు
a lot of it is very similar	వాటిల్లో చాలా వరకూ ఒకేలా ఉన్నాయి
hows it	ఎలా ఉందంటారు
its not just about cultural norms	ఇది కేవలం సంస్కృతి నీతికి సంబంధించిన సంగతి కానేకాదు
we may face fatigue discouragement or feelings of worthlessness	శారీరక లేదా మానసిక అలసట నిరుత్సాహం లేదా మనం పనికిరానివాళ్లమనే భావం
george dk	జార్జి డికె
due to the lockdown the migrant workers are leaving for their native places after unable to find work	లాక్డౌన్ కారణంగా చేస్తున్న పని పోవడంతో వలస కార్మికులు కాలి నడకన సొంత ప్రాంతాలకు వెళ్తున్నారు
the kids had to be hauled out	పిల్లల్ని లాలించాలి
jaipur rural col rajyavardhan singh rathore	రాజ్యవర్ధన్ సింగ్ రాథోర్ ఒలింపిక్ పతక విజేత జైపూర్ రూరల్
it is only about	వాటిలో లెక్క చూపేది కేవలం  శాతమే
praying together	కలిసి ప్రార్థించండి
corruption in the healthcare sector	వైద్య ఆరోగ్యశాఖలో అవినీతి జలగలు
i asked flabbergasted	అడిగాను బుజ్జగిస్తున్నట్లుగా
the incident was recorded in the cctv camera	ఈ ఘటన అక్కడ ఏర్పాటు చేసిన సీసీ కెమెరాలో రికార్డు అయ్యింది
it is used to treat liver and spleen diseases	చికిత్సా ప్రయోజనాల కోసం అది మూత్రపిండాల మరియు కాలేయం అనారోగ్యాలు నివారణకు ఉపయోగిస్తారు
i am not playing us open	నేను ఐపీఎల్లో ఆడటంలేదు
he went to the usa to watch the new york yankees match	న్యూయార్క్ వేదికగా జరుగుతున్న యుఎస్ ఓపెన్కి అతడు హాజరయ్యారు
are you interested	మీరంటే ఆసక్తి
he thanked everyone who voted for him	తన ఎన్నికకు సహకరించిన ప్రతి ఒక్కరికి కృతజ్ఙతలు తెలిపారు
i just spoke to her	నేను ఆమె గురించి మాత్రమే బహిరంగంగా మాట్లాడాను
developing a childs skills of independence is very important	పిల్లల మేధో అభివృద్ధి చాలా ముఖ్యం
the new system is expected to be operational next month	ఈ నూతన విధానాన్ని వచ్చే నెల నుండి ప్రారంభించనున్నారని సమాచారం
the us had already levied per cent tariffs on billion worth of chinese goods	అమెరికాలో  బిలియన్ డాలర్ల మేరా విలువ చేసే చైనా వస్తువులపై సుంకం శాతం పెంచుతున్నట్లు చెప్పారు
dont smoke	సీసా ఉంచవద్దు
are you responsible	నువ్వు బాధ్యత వహిస్తావా
in the end the debate was left open	ఎట్టకేలకు ఆ చర్చకు తెర పడింది
crore	కోట్లు పెరిగాయి
the entire city is dolled up	నగరమంతా జలమయం
do you exercise on an empty stomach	ఖాళీ కడుపుతో వ్యాయామం చేస్తే మంచిదా
everything is perfect	అన్నీ ఆదర్శంగానే
review hickys bengal gazette the untold story of indias first newspaper by andrew otis	ఆండ్రూ ఓటిస్ హికీస్ బెంగాల్ గెజిట్ ద అన్ టోల్డ్ స్టోరీ ఆఫ్ ఇండియాస్ ఫస్ట్ న్యూస్ పేపర్ రచయిత
the gb ram helps during multitasking	నిక్షిప్తం చేసిన జీబి ర్యామ్ వేగవంతమైన మల్టీ టాస్కింగ్కు ఉపకరిస్తుంది
then add chopped onion	తరువాత తరిగిన గుమ్మడికాయ జోడించండి
english proficiency	ఆంగ్లభాష ప్రావీణ్యం
now its more popular	ఇప్పుడు బంగ్లాదేశ్లో ఉంది
each player scores differently	ప్రతీ ఆటగాడు ఏదో ఒక షాట్ వల్ల గుర్తింపు తెచ్చుకుంటాడు
anand mahindra shares a hilarious video	గర్బా నృత్య వీడియోను షేర్ చేసిన ఆనంద్ మహీంద్రా
continuation of urban reforms like planned urbanization setting up of regulatory board auditing of accounts etc	ప్రణాళికాబద్ధమైన పట్టణీకరణ నియంత్రణ బోర్డు ఏర్పాటు ఖాతాల ఆడిటింగ్ వంటి పట్టణ సంస్కరణల కొనసాగింపు
inch	అంగుళాల
garware technical fibres	గర్వారే టెక్నికల్ ఫైబర్స్
the system is ruined	వ్యవస్థ అస్తవ్యస్తమవు తుంది
a meal for rs	మధ్యాహ్న భోజనం ఆయాల జీతాన్ని రూ
the fare at present is rs	ప్రస్తుతం ఆ బ్యాంక్ షేరు విలువ రూ
it has not yet come	ఇంకా రాలేదు
some business companies and associations participated	మొత్తం  మందికిపైగా కంపెనీలు ప్రతినిధులు పాల్గొంటున్నారు
turmeric powder tsp	మెంతి పొడి   టీ స్పూన్
following his presentation haykaz had more opportunities to speak to his classmates and to discuss the bible based position of the witnesses on blood transfusion alcohol and morals	తన నివేదిక సమర్పించడం పూర్తయిన తర్వాత హైకాస్కు తన తోటి విద్యార్థులతో మాట్లాడేందుకు రక్తమార్పిడి మద్యం నైతికతల విషయంలో సాక్షుల బైబిలు ఆధారిత స్థానం గురించి చర్చించేందుకు మరిన్ని అవకాశాలు లభించాయి
blue and orange and yellow and green	నీలం నీలం ఆకుపచ్చ రెడ్ కలర్ మరియు రిచ్ రంగుల
the markets are at an alltime high	మార్కెట్లు ఆల్టైమ్ గరిష్టాల్లో ఉన్నాయి
do abs exercises	అబ్స్ వ్యాయామాలను
ready for ipl	ఐపీఎల్ కోసం ఆతురతగా ఎద
the battle of panipat	పానిపట్ యుద్ధం
do not allow tv to rob you of these valuable moments	ఇలాంటి విలువైన సమయాన్ని దోచుకునేందుకు టీవీని అనుమతించకండి
the government has taken no such decision	ఈ సమయంలో ప్రభుత్వం ఎటువంటి నిర్ణయం తీసుకోలేదు
i dont believe in them	నాకే వాటిపై నమ్మకం లేదు
the incident caused a stir in the city	ఈ సంఘటన నగరంలో కలకలం సృష్టించింది
the airplane was a fokker belonging to iran air the fars news agency reported	ఇరాన్ ఎయిర్ సంస్థకు చెందిన ఫాకర్  విమానంలో ఈ ప్రమాదం చోటుచేసుకుంది
hope it gets	వస్తుందని ఆశిస్తున్నా  అని పేర్కొన్నారు
she was so angry	అంతే ఆమెకు కోపం వచ్చింది
asked the producers	అంటూ నిర్మాతలు ప్రశ్నించారు
the door opens again	గేట్ ఓపెన్
it earned over rs crore	కోట్లకు పైగా వసూళ్లను సాధించింది
whats the security like	భద్రత ఎలా
traditions and practices	సంప్రదాయాలు మరియు ఆచారాలు
who are these kids	ఎవరీ పిల్లలు
our two countries are very uniquely positioned to complement each other	మన రెండు దేశాలు ఉభయతారకంగా సహకరించుకోగల స్థితిలో ఉన్నాయి
to meet pm modi	ప్రధాని మోడీతో భేటీపై
the plane crashed shortly after taking off	మరికాసేపట్లో ల్యాండ్ అవుతుందనగా విమానం ఒక్కసారిగా దిశమార్చుకుంది
scroll down to watch below	ఈ దిగువ పరిశీలించి క్రిందికి స్క్రోల్ చేయండి
on the other hand some bridegrooms arrange for appropriate music a time for dancing and alcohol served in moderation	ఆఫ్రికాలో కొందరు పరిణతి లేనివారు మర్యాదకరమైన క్రైస్తవ వివాహాల్ని నిరసిస్తూ వాటికి హాజరు కావటం అంత్యక్రియలకు హాజరుకావటంగా ఉందని అంటారు
but god is god	కానీ దేవుడికి చెవుడు
for farmers rs	పాడి రైతులకు ప్రతి లీటర్పై ఇచ్చే రూ
world wide terror	ప్రపంచ తీవ్రవాదం
on the other hand priyanka chopra and nick jonas are enjoying their marital bliss to the fullest	అయితే ఇవన్నీ పక్కన పెడితే నిక్ జోనస్ ప్రియాంక చోప్రా జంట మాత్రం ఫుల్లుగా ఎంజాయ్ చేస్తూ హ్యాపీగా గడుపుతున్నారు
she won eight singles titles during her career	కెరీర్లో ఎనిమిది సింగిల్స్ టైటిళ్లను సాధించాడు
thats its specialty	అదే దీని ప్రత్యేకత
beyond the us	యునైటెడ్ స్టేట్స్ వెలుపల
vijay deverakonda gifted allu arjun a custommade rowdy brand sweatshirt and allu posted the same on twitter to thank vijay for the special gift	అల్లు అర్జున్ కు విజయ్ దేవరకొండ రౌడీ బ్రాండ్ టీ షర్ట్ ట్రాక్ మరియు స్పెషల్ మాస్క్ లను కూడా పంపించాడు
bjp has won seats	టీడీపీకి  సీట్లు వచ్చాయి
individual artists	ఆంధ్రభూమి మాసపత్రిక
the winter is starting	ఇక చలి కూడా మొదలైపోతుంది
crores	కోట్ల రూపాయలను విరాళంగా అందించారు
the incident reportedly occurred when an rtc bus hit the motorcycle	ఆర్టీసీ బస్సు ఢీకొనడంతో ఈ ప్రమాదం జరిగింది
haryana cm manohar lal khattar cast his vote in karnal	కర్నల్లో ఓటు వేసిన హర్యానా సీఎం మనోహర్ లాల్ ఖట్టర్
additional functions	అదనపు ప్రమేయాలు
final day	ఆఖరు రోజు ఆట
country france	దేశం ఫ్రాన్స్
cabinet approves raising of indian reserve battalions by jk and lwe states	కేంద్ర మంత్రివర్గ సమావేశానికి ప్రధాన మంత్రి శ్రీ నరేంద్ర మోదీ అధ్యక్షత వహించారు
seven songs	ఏడు పాటలతో కనువిందు
je suis content de vous english soldiers	నూరు తెలంగాణ నానీలు నానీలు నాన్నా
abraham lincoln was the first republican president	హత్యకు గురయిన తొలి అమెరికన్ ప్రెసిడెంట్ అబ్రహాం లింకన్
he has appeared in a number of hindi films	ఆమె పలు హిందీ చిత్రాలలో నటించింది
story line	స్టోరీ లైన్
he was later deported to saudi arabia	తర్వాత సౌదీ అరేబియాకు పారిపోయాడు
parents need to focus on their childrens behavior	పిల్లల ప్రవర్తనపై ఇంటి పెద్దలే కన్నేసి ఉంచాలి
new york jun bollywood stalwarts amitabh bachchan salman khan akshay kumar and indian cricket captain mahendra singh dhoni are among the worlds highestpaid celebrities according to the forbes annual list which is topped by by american boxer floyd mayweather	న్యూయార్క్ ప్రపంచంలోనే అత్యధిక పారితోషికం తీసుకుంటున్న టాప్  వినోదం ప్రముఖుల్లో అమితాబ్ బచ్చన్ సల్మాన్ ఖాన్ అక్షయ్ కుమార్ మహేంద్ర సింగ్ ధోనీ ఉన్నట్లు ఫోర్బ్స్ తాజాగా విడుదల చేసిన లిస్ట్లో ఉంది
however rs	కాని పంట చేతికి వచ్చే సరికి రూ
the original estimated cost of the project was rs	కాగా ఈ ప్రాజెక్టు వాస్తవ వ్యయం రూ
avoid credit card relief	క్రెడిట్ కార్డ్ డీఫాల్ట్ నుంచి సేవ్ అవండి
king became a home office law clerk in january	హైదరాబాదు రాజ్యం బ్రిటీష్ ఇండియాలో  లో రాచరిక రాజ్యంగాగా మారింది
follow physical distance	భౌతిక దూరం పాటిస్తారు
central board of direct taxes	కేంద్ర ప్రత్యక్ష పన్నుల బోర్డు వెల్లడి
the dialogues are good	డైలాగ్స్ చాలా బావున్నాయి
congress could not win even one seat	ఇక కాంగ్రెస్ ఒక్క స్థానంలోనూ విజయం సాధించలేక పోయింది
recently rs	ఇటీవల హుండీ ఆదాయం ద్వారా వచ్చిన రూ
key components of the model	మోడల్ ప్రధాన లక్షణాలు
anil ravipudi is the director	ఇవాళ దర్శకుడు అనిల్ రావిపూడి పుట్టినరోజు
gandhi jis full name was mohandas karamchand gandhi	గాంధీజీ పూర్తి పేరు మోహన్దాస్ కరంచంద్ గాంధీ మోహన్దాస్ అసలు పేరు కరంచంద్ తండ్రి పేరు గాంధీ ఇంటి పేరు గాందీ అంటే పచారి దినుసుల వర్తకుడు అని అర్థం వారి పూర్వీకులు వర్తక వాణిజ్యాలు సాగించారు కాని కొందరు వ్యాపారానికి బదులు ప్రభుత్వ ఉద్యోగాలు చేశారు తాత పోర్బందరుకు దివాను తండ
did you eat	అదేం తిండిరా
bjp is totally prepared for the assembly elections	బీజేపీ దేశవ్యాప్తంగా పార్లమెంట్ ఎన్నికలకు సంస్థాగతంగా సిద్ధమైందన్నారు
located in namakkal district in central tamil nadu region kolli hills is a riders paradise	కొల్లి హిల్స్ మధ్య తమిళ నాడులోని నమక్కల్ జిల్లాలో కలవు
here are some career options	కెరీర్ ఎంపికలు కిందివి ఉన్నాయి
social order	సోషల్ ఆర్డర్
odisha governments plea	దరఖాస్తు చేసిన ఒడిశా సర్కారు
the home currency opened at per dollar	డాలర్ మారకంలో రూపాయి  వద్ద ఫ్లాట్గా ముగిసింది
mans life is error	ఒక వ్యక్తి యొక్క జన్మదినం ఒక ముఖ్యమైన సంఘటన
no men allowed	మగవారికి ప్రవేశం లేదు
no one can	ఎవరు ఉండకపోవచ్చు
the state government bears the expenses	ఖర్చులను ప్రభుత్వాలు చెల్లిస్తున్నాయి
pm modi greets retired officers	మాజీ ఉద్యోగులను సన్మానించిన మోదీ
economy of the state is mainly dependent on agriculture	ఈ రాష్ట్ర ఆర్థిక వ్యవస్థ ప్రధానంగా ఇక్కడి వ్యవసాయ పరిస్థితులపైనే ఆధారపడి ఉంటుంది
it however failed to impress the audience	అయితే ఇది ప్రేక్షకులను ఆకట్టుకోవడంలో విజయం సాధించలేకపోయాడు
ayodhya is the birth place of lord ram	అయోధ్య రాముడు పుట్టినచోటు
article of the constitution bans engagement of children below the age of in factories mines and other hazardous employment	సంవత్సరాల లోపు పిల్లలను కర్మాగారాలలో గనులలో ఇతర ప్రమాదకరమైన పనులలో నియమించడాన్ని వ ఆర్టికల్ నిషేధించింది
governor kalyan singh and cm vasundhara raje welcomed the president by offering floral greetings at jaipur airport	రాష్ట్రపతి విమానాశ్రయం వద్దకు చేరుకోగానే కేరళ గవర్నర్ పి సదాశివన్ ముఖ్యమంత్రి పినరయి విజయన్ ప్రత్యేక స్వాగతం పలికారు
its	ది
asset quality improved as well	అస్సెట్ క్వాలిటీ సైతం మెరుగుపడింది
steps are being taken under the ecourt mission to computerize the entire court systems	న్యాయవ్యవస్థ అంతటినీ కంప్యూటరీకరించే ఇకోర్ట్ కార్యక్రమం అమలుకు చర్యలు చేపట్టాము
happy valentines day love	ప్రేమికుల రోజున ఉప్పెన వస్తోందట
crisps and chocolate cookies	చిక్పీస్ మరియు చాక్లెట్ తో బిస్కెట్లు
she couldnt answer it	ఆమె జవాబు చెప్పలేక తడబడింది
mumbai bridge collapse	ముంబయిలో కూలిన పాదచారుల వంతెన
the scared villagers had informed the forest department officials	ఎలుగుబంటి సంచారంతో భయందోళన చెందిన గ్రామస్తులు అటవీ శాఖ అదికారులకు సమాచారం అందించారు
its an unpleasant feeling	ఇది అసహ్యకరమైన అనుభూతిని కలిగిస్తుంది
two policemen die in accident	ట్రక్కు ఢీకొని ఇద్దరు పోలీసుల మృతి
sandeep died on the spot he added	సందీప్ అక్కడికక్కడే చనిపోయాడు
when do you start shooting	అంతేకాదు షూటింగ్ ఎప్పుడు స్టార్ట్ అవుతుందా
i inquired	అని ఆరా తీశాను
change is good	మార్పు మంచికే అంటున్నారు
crazy talk	పిచ్చి పిచ్చిగా మాట్లాడుతున్నారు
i thought he would win the match	వాడు గెలవడేమో అనుకున్నాను
he had told them not to follow doctors advice	అధైర్యపడకుండా వైద్యుల సలహాలను పాటించాలని ఆయనకు సూచించారు
victory venkatesh and naga chaitanya akkineni play the lead roles in the movie venky mama	విక్టరీ వెంకటేష్ అక్కినేని యంగ్ హీరో నాగచైతన్య కలిసి నటించిన చిత్రం వెంకీ మామ
be cautious while driving vehicle	వాహనం నడిపేటప్పుడు జాగ్రత్తగా ఉండండి
many people ask me	చాలా మందిని అడుగుతూ ఉంటాను
pldoras para el estrs pills for stress	మనస్సుకి ఆరాటం ఉద్విగ్నత   తగ్గించటం
who knows	ఏమో ఎవరికి తెలుసు
full details	పూర్తి వివరాల్లోకి వెళ్లే
all the best to ys jagan	వైఎస్ జగన్కు శుభాకాంక్షలు అందజేయాలంటే
i couldnt bear it	నేను భరించలేక పోయాను
it is a record in indian history	ఇండియన్ సినిమా చరిత్రలో ఇది ఓ రికార్డ్ గా చెపుతున్నారు
the industry is growing	పరిశ్రమలు పెరుగుతున్నాయి
earlier on sunday the security forces busted an old militant hideout in rajouris gadyog area of khawas in jammu and kashmir during a search operation	అంతకుముందు సెర్చ్ ఆపరేషన్లో భాగంగా ఆదివారం నాడు భారత భద్రతా బలగాలు ఖవాస్ ప్రాంతంలోని రాజౌరిలో ఓ తీవ్రవాదులు తలదాచుకున్న ఓ శిబిరాన్ని పేల్చి పారేశాయి
bus falls into gorge dead	కాలువలో పడ్డ బస్సు  మంది మృతి
when is the release date of the movie	ఫలితాల వెల్లడి ఎప్పుడు ఉంటుంది
she has acted as heroine and character roles in more than films	కి పైగా చిత్రాల్లో కథానాయకుడిగా హాస్యనటుడిగా సహాయనటుడిగా నటించాడు
it is mated to a speed gearbox	ఇది స్పీడ్ గేర్బాక్స్తో అనుసంధానం చేయబడి ఉంటుంది
in addition rs	అంతేకాకుండా రైతులకు సాయంగా రూ
demise of soldiers in siachen is very tragic	సియాచిన్ లో సైనికుల మరణం ఎంతో విషాదకరం
the state suffered	రాష్ట్రాన్ని అధోగతి పాలు చేశారు
it seems like its getting closer	అది దగ్గరగా వస్తున్నట్టు కనిపించసాగింది
director anil ravipudi	అనిల్ రావిపూడి దర్శకత్వ పర్యవేక్షణ మరో బాధ్యత తీసుకున్న స్టార్ డైరెక్టర్
institute worlds largest vaccine manufacturer is conducting trials for the vaccine developed by oxford university	ప్రపంచంలోని అతిపెద్ద టీకా తయారీ సంస్థ ఇన్స్టిట్యూట్ ఆక్స్ఫర్డ్ విశ్వవిద్యాలయం అభివృద్ధి చేసిన వ్యాక్సిన్ కోసం పరీక్షలు నిర్వహిస్తోంది
but the project has not fructified	కానీ ప్రాజెక్టు సెట్ అవ్వడం లేదు
the films preproduction was yet to be completed	ఈ చిత్రం పోస్ట్ ప్రొడక్షన్ కార్యక్రమాలు ఇంకా పూర్తి కాలేదు
article revoked	ఆర్టికల్  రద్దు ముఫ్తి కుమార్తె భావోద్వేగం
each tie consists of five rubbers which are played in three days usually on friday saturday and sunday	ప్రతి టైలో  రబ్బర్లు ఆటలు ఉంటాయి వీటిని  రోజులలో ఆడతారు సాధారణంగా శుక్రవారం శనివారం మరియు ఆదివారం
hundreds of thousands	ంద నుంచి వేలు
these examinations are essential	ఈ మూడు పరీక్షలు తప్పనిసరి
the killed included a woman and five children	మృతుల్లో ఓ చిన్నారితోపాటు ఐదుగురు మహిళలు ఉన్నారు
trifed is arranging atleast team meetings every day and the team is reaching out to partners to keep moving forward	ట్రైఫెడ్ రోజుకు కనీసం రెండు బృంద సమావేశాలను ఏర్పరచి సభ్యుల ఉన్నతికి తోడ్పడటంలో ప్రధానపాత్ర వహిస్తున్నాయి
people need to understand the situation of the state	రాష్ట్రంలో ప్రస్తుత పరిస్థితులను ప్రజలు గమనించాలి
lalu yadav in jail	లాలూ యాదవ్ జైల్లో ఉన్నారు
why do you	లా ఎందుకు పడుతున్నాయో
the entire look has changed	మొత్తం ఫేస్ కట్టే మారిపోయింది
it is rainy in summer and dry during winter	వేసవిలో ఎండతీవ్రత శీతాకాలంలో అధికంగా ఉంటుంది
lakh rs	లక్షలుఎంఎల్ సి కసిరెడ్డి నారాయణరెడ్డి రూ
congress shatru	కాంగ్రెస్ ఖుషీ
fry till the meat is cooked	డక్ మాంసం టెండర్ వరకు ఉడికించాలి
unable to cope	తట్టుకోలేక పోయాను
elopement plan	అల్లైడ్ ప్లాన్
pollution reaches to very dangerous level in delhi	దేశ రాజధాని ఢిల్లీలో కాలుష్యం స్థాయి అత్యంత ప్రమాదకర స్థితిలోకి పడిపోయింది
he didnt do well	అతను సరిగా పని చెయ్యడు
chandrababu naid	చంద్రబాబు నాయ క త్వం
because we belong to jehovah we give him exclusive devotion hence a true christian does not devote his life to some secular cause	ఆయన జాతీయ చిహ్నాలను గౌరవించినప్పటికీ చర్యల ద్వారాగానీ తన హృదయంలోగానీ వాటిని ఆరాధించడు
the book of enoch is an apocryphal and pseudepigraphic text	దాన్ని హనోకు వ్రాశాడని అబద్ధంగా ఆరోపించబడుతోంది
per ten gram of carat gold at rs	గ్రామలు  క్యారెట్ల బంగారం ధర రూ
in rs	ఉప్పల్ పరిధిలో రూ
he addressed media people at a press conference	ఈ సందర్భంగా మీడియా ప్రతినిధుల సమావేశంలో మాట్లాడారు
we learnt everything on the job she says	అన్న విషయాల గురించి ఆ ఉద్యోగం ద్వారా ఎంతో నేర్చుకున్నాను అని ఆమె గుర్తుచేసుకున్నారు
wash and clean the prawns well	బంగాళ దుంపలు శుభ్రంగా మరియు కాచు
a threemember bench of the apex court headed by chief justice asif saeed khan khosa comprising justice mazhar alam and justice syed mansoor ali shah heard the case	పెషావర్ హైకోర్టు ప్రధాన న్యాయమూర్తి జస్టిస్ వకార్ అహ్మత్ సేఠ్ సారథ్యంలో జస్టిస్ నజర్ అఖ్తర్ జస్టిస్ షాహిద్ కరీంలతో కూడిన ముగ్గురు న్యాయమూర్తుల ధర్మాసనం ఈ కేసులపై సమగ్ర విచారణ నిర్వహించింది
sureshs wife threatens suicide	చస్తానని బెదిరించడానికే వెళ్లాడు సురేశ్ భార్య
directed by sujeeth the movie is produced by uv creations	సుజీత్ దర్శకత్వం వహిస్తున్న ఈ చిత్రాన్ని యూవి క్రియేషన్స్ వారు నిర్మిస్తున్నారు
earn extra income	అదనపు ఆదాయం
the construction work is progressing quickly	దీనికి సంబంధించిన నిర్మాణం పనులు వేగవంతమవుతున్నాయి
event handler	చర్య నిర్వాహకం
some personalities make history	కొందరు చరిత్ర సృష్టిస్తారు
gearbox speed manual transmission	గేర్ బాక్స్  స్పీడ్ మ్యాన్యువల్ గేర్ బాక్స్
i dont get a lot of work	ఎక్కువ శ్రమ పడలేకపోతున్నాను
stay home if you are sick	మీరు జబ్బుపడిన ఉంటే ఇంట్లో ఉండడానికి
im ready to play	కబడ్డీ కబడ్డీ ఆడటానికి నేను రెడీ
the new lexus ls h carries forward the japanese carmakers rather distinct and eyecatching design language	జపాన్ దిగ్గజం లెక్సస్ ప్రపంచ దృష్టిని ఆకర్షించే మరియు అత్యంత భిన్నమైన డిజైన్ను తమ ఎల్ఎస్ హెచ్ సెడాన్లో అందించింది
the causes of the accident are being investigated	ప్రమాదానికి దారితీసిన కారణాలపై ఆరా తీస్తున్నారు
it does not die	అది చావదు
she has even had the joy of attending the pioneer service school caring for the increase	ఆమె పయినీరు సేవా పాఠశాలకు కూడా హాజరై దానిద్వారా ఆనందాన్ని అనుభవించింది
priyanka gandhi meeting victims family members	బాధితురాలి బంధువులను కాంగ్రెస్ నేత ప్రియాంకా గాంధీ పరామర్శించారు
ncp chief sharad pawar cpm general secretary sitaram yechury and cpis s sudhakar reddy attended the meeting	ఈ భేటీలో సిపిఐ జాతీయ ప్రధాన కార్యదర్శి సురవరం సుధాకర్రెడ్డితో పాటు సిపిఐ సీనియర్ నేత రాజా సిపిఐ నారాయణ తదితరులు పాల్గొన్నారు
she posted the photos on facebook	తరువాత ఆ ఫోటోలు ఫేస్ బుక్ లో షేర్ చేశాడు
do you wake up feeling tired in the morning	మీరు ఉదయం జబ్బుపడిన అనుభూతి
china warning	చైనా అప్రమత్తం
researchers studied men over a day period and fed them more of their energy required every day through fats and carbohydrates	పరిశోధకులు  రోజులపాటు  మంది పురుషులను అధ్యయనం చేశారు మరియు కొవ్వులు మరియు కార్బోహైడ్రేట్ల ద్వారా వారికి రోజుకు కావలసిన దాని కన్నా  అధిక శక్తిని తినిపించారు
category c	వర్గం
the ears get blocked	చెవులు దిబ్బడేసినట్టు ఉంటాయి
foreign media	ఇక విదేశీ మీడియా కూడా
he is like my father	అచ్చం నాన్నలా ఉన్నాడు
social media dictates everything	సోషల్ మీడియా ప్రతీ విషయంపై సెటైర్లు వేస్తూ ఉంటాడు
australia lose their first wicket	తొలివికెట్ కోల్పోయిన ఆస్ట్రేలియా
special appeal no	ఎ స్పెషల్ అప్పీల్ నెం
he promised the waiver of farmers loan upto lakh	లక్షల రుణ మాఫీ చేస్తామని ఆయన హామీ ఇచ్చారు
the rajasthan government has approached the supreme court to appeal against the order of rajasthan high court acquitting actor salman khan in two cases involving poaching of chinkaras an endangered animal under the wildlife protection act	వన్య ప్రాణులను వేటాడిన కేసుల్లో సల్మాన్ఖాన్ నిర్దోషిగా విడుదల చేయడాన్ని సవాల్ చేస్తూ రాజస్థాన్ ప్రభుత్వం సుప్రీంకోర్టును ఆశ్రయించిన విషయం తెలిసిందే
then both the men between whom the controversy is shall stand before the lord before the priests and the judges which shall be in those days	ఆ వివాదముగల ఇద్దరు మనుష్యులు యెహోవా సన్నిధిని అనగా ఆ కాలములోనున్న యాజ కుల యెదుటను న్యాయాధిపతుల యెదుటను నిలువ వలెను
but she did not speak	అయినా ఆమె నోటినుంచి మాటలు రావడంలేదు
government flayed	తల వంచిన ప్రభుత్వం
the definition is somewhat incomplete	ఖచ్చితమైన నిర్వచనం కొంతవరకు అస్పష్టంగా ఉంది
notes	నోటు
the hyundai kona electric vehicle has received customer bookings in just days	విడుదలైన  రోజుల వ్యవధిలో  మంది కస్టమర్లు హ్యుందాయ్ కోనా ఎలక్ట్రిక్ కారును బుక్ చేసుకున్నారు
the two broke up soon after	అంతలోనే ఇద్దరూ విడిపోయారు
kurnool due to heavy rainfall in upper catchment areas the srisailam reservoir is receiving heavy inflows of floodwater	విశాలాంధ్ర బ్యూరో కర్నూలు  ఎగువ నుంచి పెద్దఎత్తున వరద నీరు చేరుతున్న తరుణంలో శ్రీశైలం జలాశయం నిండుతోంది
lakh	లక్షల అపహరణ
consider how you can prevent accidents caused by drowsiness and by the effects of aging	నిద్రమత్తుగల డ్రైవరు
the park is located on the flood plains of the murti river and raidak river	ముర్తీ నది రైదాక్ నదుల వరద మైదానాల్లో ఈ పార్కు ఉంది
the method is as follows	పద్దతి కింది విధంగా పద్ధతి
theres so many possibilities	అక్కడ ఎంపికలు చాలా ఉన్నాయి
governments instructions	ప్రభుత్వనుంచి రాని ఆదేశాలు
display preferences	ప్రదర్శనా అభిరుచులు
rs crore	కోట్లు కేటాయిస్తున్నాం
fitness band	ఫిట్నెస్ బ్యాండ్
she was allegedly forced to flee to the united states over safety concerns	భద్రతా కారణాల వల్ల ఆమె బలవంతంగా హాంకాంగ్ను వీడాల్సి వచ్చింది
he died of lung cancer	మూత్రాశయ క్యాన్సర్ కారణంగా ఆయన తుది శ్వాస విడిచారు
are no longer printed	నోట్లను ముద్రించడం లేదు
haryana the first state	తొలిసారి హర్యానాలో
a human number	ఒక మనుష్యుని సంఖ్య
certainly not	ఖచ్చితంగా  కాదు
these include canada australia usa south africa and uk	ఇందులో ఆస్ట్రేలియా అంటార్కిటికా దక్షిణ అమెరికా మరియు దక్షిణ ఆఫ్రికా ఉన్నాయి
headless body	తల లేని మృతదేహం
not the face	ుఖం కూడా చూడకుండా
the german culture had started before the germany became	జర్మనీ జాతీయదేశంగా అయ్యే ముందే జర్మన్ సంస్కృతి ఆరంభంయ్యింది మరియు జర్మన్ మాట్లాడే ప్రపంచమంతా ఇది విస్తరించింది
the state government has earmarked rs	గురుకుల విద్యార్థుల కోసం రాష్ట్ర ప్రభుత్వం బడ్జెట్లో రూ
the allies decided to give seats to jmm to congress party and seven to rjd	కాంగ్రెస్జెఎంఎం ప్రతిపక్ష కూటమి సీటు పంచుకునే ఒప్పందాన్ని కూడా ప్రకటించింది   మంది జెఎంఎంకు  మంది కాంగ్రెస్కు మిగిలినవి రాష్ట్ర జనతాదళ్ ఆర్జెడి కు వెళ్లాయి
a godly woman she had earlier acquired the two volumes of the book light bible study aids distributed by jehovahs witnesses	దైవభక్తిగల ఆమె అంతకుముందు యెహోవాసాక్షులు పంచిపెట్టిన బైబిలు అధ్యయన సహాయకమైన లైట్ పుస్తకపు రెండు సంపుటాలను సంపాదించింది
the nonrefundable application fee of rs	దీని కోసం దరఖాస్తు చేసుకునే నాన్ రిఫండబుల్ ఫీజు ధర రూ
rgv is on a roll once again	ఆర్జీవీ మళ్లీ ఫామ్ లోకి వచ్చాడు
become aware	అవగాహన కల్పించండి
lakh crore	కోట్లు కలెక్ట్ చేసి మొత్తంగా రూ
the attack killed crpf men	పేలుడు దాడికి  మంది సీఆర్పీఎఫ్ జవాన్లు నెలకొరిగారు
farmers are protesting for their survival	వారి హక్కుల కోసం రైతులు పోరాడుతున్నారు
it was followed by the indian institute of science bengaluru and the iitdelhi	దాని తర్వాత బెంగలూరు ఇండియన్ ఇనిస్టిట్యూట్ ఆఫ్ సైన్స్ నిలిచింది
three died on the spot while the other two succumbed after being admitted at a hospital	వేగంగా వస్తున్న కారును లారీ ఢీకొనడంతో సంఘటనాస్థలంలో ఇద్దరు అక్కడికక్కడే మృతిచెందగా మరో ముగ్గురు ఆసుపత్రిలో చికిత్సపొందుతూ మరణించారు
last word	చివరి మాటగా
the governments move is unwarranted	ప్రభుత్వ విధానం అనాలోచితంగా ఉంది
the bill would give reservation in educational institutions and government jobs to those living within the kilometre radius of the international border in jammu	జమ్ములో అంతర్జాతీయ సరిహద్దుకు  కిలోమీటర్లు కశ్మీర్లో నియంత్రణకు  కిలోమీటర్ల దూరంలో నివసించే యువతకు విద్యాసంస్థలు ప్రభుత్వ ఉద్యోగాల్లో రిజర్వేషన్ కల్పించనున్నారు
support weight loss	బరువు కోల్పోవటానికి మద్దతు పొందండి
come on come on come on come on	న కమ్ ఆన్ వచ్చి న వస్తాయి న వస్తాయి
would we meet again	మనం మళ్లీ కలుద్దామా
crore	కోట్లు మడ్డువలసకు రూ
a litre of diesel costs rs	డీజిల్ లీటరు ధర రూ
six armed criminals arrested	ఆరుగురు పేకాటరాయుళ్లు అరెస్ట్
whether the scroll wheel should be used for zooming	పెద్దదిగా చేయుట కొరకు స్క్రాల్ చక్రాన్ని ఉపయోగించాలా వద్దా
the side profile of the suv sports flared wheel arches and character lines across the body	సైడ్ ప్రొఫైల్లో ఆకర్షణీయమైన స్పోర్ట్స్ వీల్ ఆర్చెస్ మరియు క్యారెక్టర్ బాడీ లైన్స్ ఉన్నాయి
praise god	దేవునిమీద ఆన
directed by chandoo mondeti the movie is produced by mythri movie makers	చందూ మొండేటి దర్శకత్వంలో రూపొందిన ఈ చిత్రాన్ని మైత్రీ మూవీ మేకర్స్ సంస్థ నిర్మించింది
senior bjp leaders mlas former mlas and mps took part in the demonstration in all the districts	రాష్ట్రంలోని ప్రధానమైన జిల్లాల టీడీపీ అధ్యక్ష ప్రధాన కార్యదర్శులు మాజీ ఎమ్మెల్యేలు నియోజకవర్గ ఇన్చార్జీలతోపాటు క్షేత్రస్థాయిలోని టీడీపీ శ్రేణులందరినీ బీజేపీలో చేర్చుకునేలా చర్యలు చేపట్టింది
take good care	తగు జాగ్రత్తలను వహించండి
the father of the indian space programme vikram sarabhai is a highly awarded scientist and innovator	విక్రం సారాభాయ్ పలు అవార్డులు గెలుచుకున్న భౌతిక శాస్త్రవేత్త భారత అంతరిక్ష పరిశోధన సంస్థ ఇస్రో ఆవిష్కర్త
its happened before	ఇంతకు ముందే జరిగింది
chennai the madurai bench of madras high court has granted conditional anticipatory bail to makkal needhi maiam chief kamal haasan	హైకోర్టు మధురై ధర్మాసనం కమల్ హాసన్కు షరతులతో కూడిన ముందస్తు బెయిల్ మంజూరు చేసింది
for example in jesus parable of the prodigal son when the son returned home and offered a heartfelt apology the father was more than ready to receive him back into the household	ఉదాహరణకు తప్పిపోయిన కుమారుని గురించి యేసు చెప్పిన ఉపమానంలో కుమారుడు ఇంటికి తిరిగి వచ్చి హృదయపూర్వకంగా క్షమించమని అడిగినప్పుడు తండ్రి అతడిని తిరిగి ఇంట్లోకి చేర్చుకోవడానికి ఎంతో ఆత్రుత చూపించాడు
special coaching is given to weak students	చదువులో వెనుకబడిన విద్యార్థులకు ప్రత్యేక శిక్షణ ఇస్తాం
its bound to	దానికే కట్టుబడి ఉంది
the list was topped once again by microsoft founder and philanthropist bill gates	ఈ లిస్ట్లో మైక్రోసాఫ్ట్ సహ వ్యవస్థాపకులు బిల్గేట్స్కు మరోసారి అగ్రస్థానం దక్కింది
political parties in reverse gear	పావులు కదుపుతున్న రాజకీయ పార్టీలు
whether to use the default system color	అప్రమేయ వ్యవస్థ వర్ణపు ఉపయోగించాలా
three children killed in fire	గడ్డివాములో చెలరేగిన మంటలు ముగ్గురు చిన్నారులు సజీవ దహనం
all religious placesplaces of worship	అన్ని ప్రార్థన స్థలాలు మతపరమైన స్థలాలు
prem kumar who helmed the original version is directing the telugu version as well	ఒరిజినల్ వెర్షన్ ను డైరెక్ట్ చేసిన ప్రేమ్ కుమార్ తెలుగు రీమేక్ ను డైరెక్ట్ చేస్తున్నారు
theres a good vibe here	ఇక్కడ గాలి మంచిది
losing the match by runs	పరుగుల వద్దే ఆగిపోయారు
many of these workers are women	ఇందులో ప్రధాన కార్మికులు స్త్రీలు
telugu and tamil remakes are on the way	తెలుగు తమిళ చిత్రాలతో జోరు కొనసాగిస్తున్నది
the total budget is rs	మొత్తం ఆరోగ్యుశ్రీ ఏడాది బడ్జెట్ రూ
cases in the state are going down since month of october	రాష్ట్రంలో వచ్చే నెలాఖరుకు కేసులు తగ్గి పోతాయి
close others	ఇతరులను మూసివేయి
you can play both as individuals or as teams	మీరు వ్యక్తిగతంగా లేదా జట్లుగా ఆడవచ్చు
it requires no expenditure	ఎలాంటి ఖర్చు అవసరం లేదు
how long did she take to deliver it	దానికి మొలక రావడానికి ఎంత సమయం పట్టింది
the child was crying	ఆ పిల్ల ఏడుస్తూ వచ్చింది
he later returned to the congress	దీంతో ఆయన తిరిగి కాంగ్రెస్ గూటికి చేరాడు
the elections are coming	ఎన్నికలు వచ్చేశాయి
city residents	నగరవాసులకు ఊరట కలిగిస్తున్నాయి
the dead include women and a boy	మృతి చెందిన వారిలో ఏడుగురు మహిళలు ఓ బాలుడున్నారు
lowers the body temperature	శరీర ఉష్ణోగ్రత తగ్గింపు
allepey beach	అలప్పే బీచ్
he married lakshmi and their son was krtavirya the father of kartavirya arjuna	హరిహర రాయలు కాటయవేమునితో సంధిచేసుకొని అతని కొడుకు కాటయకూ తన కూతురు లక్ష్మికి వివాహం జరిపించాడు
records galore	భలే రికార్డులు
pages	పేజీలు
uddhav thackeray aditya thackeray	ఆదిత్య థాక్రే ఉద్ధవ్ థాక్రే
he asked jovially	ఉత్సాహంగా అడిగాడు
crores	కోట్లకు క్షీణించింది
coconut oil tablespoons	ఆలివ్ నూనె   టేబుల్
i require a lot of money	నాకు డబ్బు అవసరం చాలా ఉంది
again myself	మరోసారి నేను
rs crore	కోట్లు గెలుచుకునేదే కానీ రూ
meeting of the working group on counter terrorism september new delhi	ఉగ్రవాద వ్యతిరేక పోరాటం పైన ఏర్పడిన వర్కింగ్ గ్రూపు సమావేశం   సెప్టెంబర్  న్యూ ఢిల్లీ
he has stayed at their home in hyderabad	హైదరాబాద్లోని తన నివాసంలో ఊరివేసుకున్నారు
people went astray	జనం తప్పట్లు కొట్టారు
leave them be	వాటిని అలా వదిలేయండి
portrait photography	చిత్తరువు ఫోటోగ్రఫీ
he is undergoing treatment at the hospital since long	గత కొంతకాలంగా అనారోగ్యంతో బాధపడుతూ ఆస్పత్రిలో ఆయన చికిత్స పొందుతున్నారు
emergency medical officer of mission hospital	మిషన్ హాస్పిటల్ యొక్క అత్యవసర వైద్య అధికారి
necessary conditions	మీకు అవసరమైన పరిస్థితులు
the relation between telugu desam party which ruled andhra pradesh and congress party which was in power in the centreinstead of the normal feeling of competitors between political parties a feeling of enemity developed between these two political parties	రాజకీయపార్టీల మధ్య ఉండే ప్రత్యర్థి భావన కాక శతృత్వ భావన నెలకొందిఇది తెలుగుదేశం పాలిత ఆంధ్ర ప్రదేశ్ కు కాంగ్రెసు పాలిత కేంద్రానికీ మధ్య వివాదంగా మారే వరకు వెళ్ళింది
the site of harappan city makes a very interesting and mysterious attraction to tour through	హరప్పా నగరంలో అరుదైన విశేషం అంటే ఆ నాటి నీటి సరఫరా విధానం
each entity has its own attributes and distinct qualities	వాటిని ప్రతి దాని స్వంత ప్రత్యేక లక్షణాలను మరియు లక్షణాలను కలిగి ఉంది
mumbai indians produced a clinical performance to beat royal challengers bangalore by runs in a highscoring affair to register their maiden win in ipl	ముంబై కీలకమైన మ్యాచులో దూకుడుగా ఆడి రాయల్ చాలెంజర్స్ బెంగళూర్ జట్టు ఐపియల్ లో నాకౌట్ ఆశలను సజీవం చేసుకుంది
lets find out together	అది కలిసి బయటకు దొరుకుతుందాం
section is in place in the whole area	అన్ని ప్రాంతాల్లోనూ వ సెక్షన్ అమలు
not just cute	ఇది ఐహికమైనది కాదు
bach lour boss bank believer bible bills beginning bar bag balloon best bedroom basin biscuit barry	బాచిలరు బాసు బ్యాగు బెయిటు బ్యాంకు బ్యాలెన్సు బాలు బెలూనుబ్యాలెటు బ్యాను బ్యాండు బ్యాంగిల్సు బ్యానరు బాప్తిస్మం బారు బార్బరు బార్లీ బ్యారను బ్యారేజి బారికేడుబేసుబాలు బేసుమెంటు బేసిను బాస్కెటు బ్యాచిబాత్రూము బ్యాటరీ బెడ్రూము బేరరు బీటు చీఫు బెగ్గరు బిగినింగు బిలీవరు బెల్లు బెంచి బెనిఫిటు బెస్టు బెటర్మెంటు బైబిలు బిడ్డు బిట్టు బిల్లు
everybody has a right to protest in democracy	పార్లమెంటులో నిరసన తెలిపే హక్కు అందరికీ ఉంటుందన్నారు
the murder was caught on cctv cameras	సిసిటివీ కెమెరాల్లో ఈ హత్యకు సంబంధించిన దృశ్యాలు రికార్డయ్యాయి
the mim president and hyderabad mp asaduddin owaisi has voiced concern over it	దీనిపై ఎంఐఎం అధినేత ఎంపీ అసదుద్దీన్ ఒవైసీ హర్షం వ్యక్తం చేశారు
why do we need calcium	ఎందుకు మేము కొలెస్ట్రాల్ చేయాలి
kids stuff	పిల్లల చేష్టలు
the atmosphere is very relaxed	పర్యావరణం చాలా సడలించింది
the place offers a plethora of gorgeous scenic vistas	ల ఎత్తున కల ఈ ప్రదేశం అనేక సుందర ప్రకృతి దృశ్యాలు కలిగి వుంది
the rural engineering department	గ్రామీణ ఇంజనీరింగ్ విభాగం
put green tea leaves in a bowl and add the hot water to it	గ్రీన్ టీ ఆకులను గ్లాసు నీటిలో వేసి బాగా మరిగించి గోరువెచ్చగా తాగాలి
for further details	మరిన్ని వివరాలకు అడ్మిషన్స్
these cases are still in the courts	ఇప్పటికీ ఈ కేసుల కోర్టులో నానుతూనే ఉన్నాయి
how to reach by road	ప్రజా రవాణా ద్వారా ఎలా పొందడానికి
living well is important	బ్రతకడం ముఖ్యం
its not a phone number	ఒక్క ఫోన్ నెంబర్లనే కాదు
the accident was an unfortunate one	ప్రమాదం జరగడం దురదృష్టకరమన్నారు
safety gadgets yes	సురక్షిత పరికరాలు కలవు
sometimes its just a matter of one word	కొన్ని సార్లు కేవలం కొన్ని పదాలతో జోకొడుతుంది
the central part of the state is dominated by the finger lakes a popular vacation and tourist destination	రాష్ట్రం లోని మధ్య ప్రాంతం ఫింగర్ సరస్సులతో కూడుకుని పర్యాటక ప్రదేశంగా ప్రజాదరణ పొందుతోంది
so im shutting it down	ప్రస్తుతము దీనిని మూసివేశారు
polling to all seats in tamil nadu was slated for april in the second stage of the lok sabha polls	తమిళనాడులో మొత్తం  లోక్సభ నియోజకవర్గాల్లో రెండో దశలో పోలింగ్ జరగనుంది
the voter has won	ఓటర్ల మనసు గెలుచుకున్నారు
mash both ingredients well	ఈ రెండు పదార్థాలని బాగా కలిపి మిశ్రమాన్ని తయారుచేసుకోండి
i extend my warm greetings to the people of our country on the auspicious occasion of navroz which marks the beginning of parsi new year	పార్శీ కొత్త ఏడాదిని సూచించే పవిత్రమైన నవ్రోజ్ సందర్భంగా దేశ ప్రజలకు నా శుభాకాంక్షలు
want a big catch	పెద్ద బన్స్ కావాలా
the strength of the passphrase	సంకేతపదం యొక్క పటిష్టత
dont kill	హత్య చేయవద్దు
rinse after halfanhour	అరగంట తర్వాత చన్నీటితో కడుక్కోవాలి
you want more stories like these	ఇలాంటి ఆసక్తికరమైన కథలను మీరు మరిన్ని తెలుసుకోవాలనుకుంటున్నారా
yuvraj singh gives a hilarious reply to harbhajan singhs tweet	భారత స్పిన్నర్ హర్భజన్ సింగ్ చేసిన ట్వీట్కు యువరాజ్ ఫన్నీగా సమాధానమిచ్చాడు
in the final both teams played well	తుదిపోరులో రెండు జట్లు హోరాహోరీగా తలపడ్డాయి
pushed into debt	అప్పుల ఊబిలోకి నెట్టారు
income tax refund	ఆదాయపు పన్ను తిరిగి
the vardar banovina was divided between bulgaria and italianoccupied albania	వర్డర్ బానోవినా బల్గేరియా ఇటాలియన్ ఆక్రమిత అల్బేనియా మధ్య విభజించబడింది
crore	కోట్లు వసూలు చేశాయి
now the chief priests and elders and all the council sought false witness against jesus to put him to death	ప్రధానయాజకు లును మహా సభవారందరును యేసును చంపవలెనని ఆయనకు విరోధముగా అబద్ధసాక్ష్యము వెదకుచుండిరి కాని
we dont want anyone to interfere in the internal affairs of the country	ఒక దేశ అంతర్గత వ్యవహారాల్లో జోక్యం చేసుకోవడం తమకు ఇష్టం ఉండదన్నారు
healthy mommy healthy baby	ఆరోగ్యకరమైన తల్లి  ఆరోగ్యవంతమైన బిడ్డకు
do you watch tv	టీవీ సీరియల్సేమైనా చూస్తున్నావా వదినా
naga shaurya rajendra prasad veteran actress lakshmi are seen in prominent roles	నాగశౌర్య రాజేంద్రప్రసాద్ రావు రమేష్ సీనియర్ నటి శ్రీలక్ష్మి తదితరులు కీలకపాత్రల్లో నటించారు
timely salary	సమయం వేతనాలు
it can be done here as well	ఇక్కడ కూడా అచ్చం అలానే చేయొచ్చు
no run off the last ball	చివరి బంతి వరకు తప్పదు
nellore district	పొట్టి శ్రీరాములు నెల్లూరు జిల్లా
bollywood star shraddha kapoor is playing the female lead in the movie	బాలీవుడ్ స్టార్ హీరోయిన్ శ్రద్దా కపూర్ ఈ చిత్రంలో హీరోయిన్గా నటిస్తుంది
every song is different	ఇలా ప్రతీ పాటా ఆణిముత్యమే
under the pmdp an amount of rs	పీఎంఈజీపీ కింద రూ
encourage the players	క్రీడాకారులను ప్రోత్సహించాలి
young openers prithvi shaw and mayank agarwal added runs for the opening wicket	ఓపెనర్లు మయాంక్ అగర్వాల్ పృథ్వీ షా తొలి వికెట్ కు  పరుగుల భాగస్వామ్యం నెలకొల్పి మంచి ఓపెనింగ్ ఇచ్చారు
if you typed in the address check your spelling could just be a typo	మీరు చిరునామాలో టైప్ చేస్తుంటే మీ స్పెల్లింగ్ తనిఖీ చేయండి కేవలం అక్షర దోషం కావచ్చు
he lives in bombay	తను బాంబేలో ఉంది
when i get up in the morning i say to myself its great im going preaching today	నేను ఉదయం నిద్రలేచినప్పుడు మనసులో  వావ్
check and repair the array	ఎరేను పరిశీలించి మరియు రిపేరు చేయుము
amitabh bachchan is the biggest fan of daughter shweta	బాలీవుడ్ మెగాస్టార్ అమితాబ్ బచ్చన్ కు కూతురు శ్వేత అంటే ప్రేమ ఎక్కువ
